Fila,Prompt,Idioma original,en,es,unknown,total,contamination,words,unknown_words
0,"In the realm of emotions, the Water card invites you to explore the depths of your subconscious. It reflects your deepest feelings and hidden truths, allowing you to connect with your true self. Emotions, once turbulent, are a vital source of information about your inner world. By embracing your emotional sensitivity, you can navigate through life with greater understanding and empathy. The Water card encourages introspection, helping you identify dominant emotions and their impact on daily life. It also inspires you to evaluate how these emotions influence decision-making and interactions with others. Embrace the emotional journey, for it is through your feelings that you can truly connect with others and uncover your innermost self.",en,101,14,0,115,0.122,"['invites', 'to', 'explore', 'to', 'true', 'once', 'are', 'a', 'vital', 'can', 'inspires', 'to', 'embrace', 'can']",[]
1,"In the realm of thought and communication, the card of Air represents the vital breath that animates the mind. It is through this exchange of spiritual influences that human consciousness is enriched, allowing for the discernment of higher wisdom. The card invites you to explore the quality of your internal dialogue and its impact on your perception of reality, suggesting that clarity in thought and communication can lead to a deeper understanding of oneself and one's surroundings.",en,68,10,0,78,0.128,"['vital', 'human', 'invites', 'to', 'explore', 'dialogue', 'reality', 'can', 'to', 'a']",[]
2,"The Three of Wands, in the context of the Earth card, invites you to reflect on the tangible aspects of your spiritual journey. It suggests that your spiritual growth is not just about abstract ideas but also about the physical manifestation of your beliefs and emotions. The card encourages you to consider how your actions and decisions impact the material world, including your health, finances, and the environment. It prompts you to evaluate your relationship with the material world and to seek a balanced and sustainable approach that aligns with your deepest values.",en,83,10,0,93,0.108,"['invites', 'to', 'tangible', 'ideas', 'to', 'material', 'to', 'material', 'to', 'a']",[]
3,"In the context of the Earth card, the Ten of Pentacles, your journey is one of navigating the tangible aspects of existence, from the solid foundation of your physical body to the fertile ground of your resources. This card invites you to reflect on how your spiritual aspirations align with your daily practices, particularly in managing your health, finances, and the environment. It encourages a balanced approach that nurtures personal growth and fulfills your deepest values, much like the Earth itself provides sustenance and stability.",en,76,9,0,85,0.106,"['ten', 'tangible', 'solid', 'body', 'to', 'invites', 'to', 'a', 'personal']",[]
4,"In the realm of the Self-Knowledge Star Spread, the Earth card invites you to reflect on the tangible aspects of your existence. It prompts you to consider how your spiritual aspirations align with your daily practices, particularly in relation to your relationship with the material world, health, and the environment. This card challenges you to cultivate a balanced and sustainable approach that reflects your deepest values, ensuring that your actions are grounded in the solid foundation of Earth, nurturing personal growth and fulfillment.",en,73,11,0,84,0.131,"['invites', 'to', 'tangible', 'to', 'to', 'material', 'to', 'a', 'are', 'solid', 'personal']",[]
5,"In the realm of emotions, the Queen of Pentacles invites you to explore the depths of your subconscious. As the mirror of Water, she reflects your deepest feelings and hidden truths. Embrace your emotional sensitivity, for it is a vital source of wisdom and self-knowledge. Connect with your inner world, allowing the turbulent waters of emotion to guide you in understanding your true self and the impact of your decisions. Emphasize empathy, for it fosters deeper connections with others and enhances your ability to navigate through life's complexities. Honor your emotional journey, for it is a path to self-discovery and connection.",en,90,14,0,104,0.135,"['queen', 'invites', 'to', 'explore', 'as', 'embrace', 'a', 'vital', 'to', 'true', 'to', 'honor', 'a', 'to']",[]
6,"The Ten of Cups card, in the context of the Fire card, invites you to explore the depths of your innermost desires and the transformative power of your will. It suggests that by aligning your authentic desires with a higher purpose, you can ignite a transformative journey that burns away the old to create space for new, vibrant expressions of self. This card challenges you to reflect on the motivations behind your actions and decisions, urging you to consciously channel your inner strength for the sake of personal growth and transformation.",en,79,12,0,91,0.132,"['ten', 'invites', 'to', 'explore', 'a', 'can', 'a', 'to', 'to', 'to', 'sake', 'personal']",[]
7,"The Four of Cups, an Earth card, invites you to reflect on the tangible aspects of your existence. It symbolizes the materialization of your deepest desires and the capacity to sustain life. This card challenges you to evaluate your relationship with the material world, including your health, finances, and the environment. It encourages a balanced and sustainable approach that aligns with your spiritual aspirations. By nurturing your connection with the Earth, you can find inner peace and fulfill your deepest values.",en,73,8,0,81,0.099,"['invites', 'to', 'tangible', 'to', 'to', 'material', 'a', 'can']",[]
8,"In the realm of Fire, the Ten of Swords stands as a symbol of the transformative power of inner strength. It invites us to reflect on the journey of self-discovery, where the drive and willpower ignite the flames of creativity and determination. This card suggests that by recognizing and properly channeling our inner power, we can burn away what is old and obsolete, allowing for the emergence of new creations. It challenges us to examine our authentic desires and align them with a higher purpose, urging us to use our inner strength consciously and deliberately for personal growth and transformation.",en,88,12,1,101,0.119,"['ten', 'as', 'a', 'invites', 'to', 'can', 'to', 'examine', 'a', 'to', 'use', 'personal']",['willpower']
9,"The Ace of Cups, a card steeped in the essence of Earth, invites you to explore the profound connection between your inner world and the tangible aspects of your existence. It prompts you to reflect on how your deepest emotions and beliefs materialize into the physical world, shaping your actions and the environment around you. This card encourages you to consider the balance between your spiritual aspirations and your daily practices, urging you to cultivate a sustainable approach that aligns with your deepest values. As you navigate through life, remember that your emotions and beliefs have the power to create tangible realities, and it is your responsibility to nurture and sustain life in all its forms.",en,102,14,0,116,0.121,"['a', 'invites', 'to', 'explore', 'tangible', 'to', 'to', 'balance', 'to', 'a', 'as', 'to', 'tangible', 'to']",[]
10,"The Page of Wands invites you to explore the depths of your emotions, to immerse yourself in your inner world. It calls for introspection, to identify and understand your dominant emotions, how they influence your daily life, and your decision-making processes. The card suggests evaluating the impact of these emotions on your interactions with others, fostering deeper connections and understanding. Embrace your emotional sensitivity as a tool for connection and self-discovery, allowing the flow of emotions to guide you on your journey.",en,75,9,0,84,0.107,"['invites', 'to', 'explore', 'to', 'to', 'embrace', 'as', 'a', 'to']",[]
11,"In the context of the Earth card, the reading invites you to reflect on the balance between your spiritual aspirations and your daily practices. It challenges you to evaluate your relationship with money, health, and the environment, promoting a balanced and sustainable approach that reflects your deepest values. The card symbolizes the tangible aspect of your existence, including your physical environment and the resources you manage. It invites you to consider how your beliefs and emotions translate into actions, providing fertile ground for personal growth and fulfillment. The final point of the descent of spirit into matter is represented by the Earth card, where concepts become concrete reality. This element is essential for understanding how our ideas and emotions manifest into tangible forms.",en,109,14,0,123,0.114,"['invites', 'to', 'balance', 'to', 'a', 'tangible', 'invites', 'to', 'personal', 'final', 'concrete', 'reality', 'ideas', 'tangible']",[]
12,"El Emperador, en su papel de gobernante y creador, simboliza la sabiduría y la autoridad que se obtiene a través de la introspección y la comprensión profunda de las emociones. Su poder reside en la capacidad de canalizar y transformar las emociones turbulentas en algo más constructivo, como una fuente vital de información sobre el verdadero ser y las necesidades de uno. La carta de Agua, como un espejo, refleja estas emociones y profundidades ocultas, permitiendo a las personas conectarse con sus propios sentimientos más íntimos y la sabiduría intuitiva que ofrecen. La introspección y la toma de decisiones basada en emociones pueden ser herramientas poderosas para la autodescubrimiento y la conexión con otros.",es,0,111,3,114,0.0,[],"['conectarse', 'íntimos', 'autodescubrimiento']"
13,"La Templanza, en su papel como carta del Tarot, simboliza la necesidad de equilibrar y perfeccionar las funciones mentales y la comunicación. En el contexto de Aire, este equilibrio se refuerza como una oportunidad para conectar con la sabiduría superior y promover la claridad mental. La carta invita a explorar cómo los pensamientos y palabras moldean la realidad personal, sugiriendo que la claridad en esta área puede conducir a un entendimiento más profundo de uno mismo y del entorno.",es,0,79,0,79,0.0,[],[]
14,"La Tierra, en este contexto, simboliza la conexión entre el espíritu y la materia, la materialización de ideas y emociones en formas tangibles. Invita a reflexionar sobre cómo interactuamos con el mundo material, sobre cómo gestionamos nuestros recursos y cómo alineamos nuestras aspiraciones espirituales con nuestras prácticas diarias. Te invita a evaluar tu relación con el dinero, la salud y el medio ambiente, promoviendo un enfoque equilibrado y sostenible que refleje tus valores más profundos.",es,0,75,0,75,0.0,[],[]
15,"La Tierra, en este contexto, simboliza la manifestación tangible de nuestras emociones y creencias, incluyendo la relación con el cuerpo, recursos y el entorno físico. La carta de Tiros invita a reflexionar sobre cómo interactuamos con el mundo material y cómo gestionamos nuestros recursos. La lectura sugiere que debemos evaluar nuestra relación con la salud, el dinero y el medio ambiente, promoviendo un enfoque equilibrado y sostenible que refleje nuestros valores más profundos.",es,0,73,0,73,0.0,[],[]
16,"La carta de la Reina de Espadas en el contexto de Tierra invita a reflexionar sobre la materialización tangible de nuestras emociones y creencias. Ella representa la estabilidad y la manifestación física, como el cuerpo y los recursos del mundo material. La Reina de Espadas simboliza la capacidad de sostener y nutrir la vida, ofreciendo un terreno fértil para el crecimiento y la realización personal. Ella invita a evaluar la alineación entre aspiraciones espirituales y prácticas diarias, promoviendo un enfoque equilibrado y sostenible que refleje valores profundos.",es,0,87,0,87,0.0,[],[]
17,"La Reina de Oros, en su papel de regente del Tarot, simboliza la sabiduría y la autoridad. Su presencia en el contexto de Agua invita a explorar las profundidades emocionales y a conectar con la intuición. La carta sugiere que debemos honrar la sensibilidad emocional como herramienta de conexión y autodescubrimiento, invitando a la introspección para identificar emociones dominantes y su impacto en la vida diaria.",es,0,64,2,66,0.0,[],"['autodescubrimiento', 'dominantes']"
18,"La carta de la Diez de Copas en este contexto simboliza la energía vital que impulsa la transformación. Es como una llama que se enciende en el corazón de cada ser humano, encendiendo la motivación y la determinación para manifestar su voluntad en el mundo físico. Esta energía, tanto destructiva como constructiva, permite que se queme lo que es viejo y obsoleto, dando espacio a nuevas creaciones y permitiendo el reinado de cada individuo. La carta invita a reflexionar sobre los deseos auténticos que impulsan nuestras acciones y cómo alinearlos con un propósito superior, fomentando el crecimiento personal y la transformación.",es,0,100,1,101,0.0,[],['alinearlos']
19,"La Tierra, en este contexto, simboliza la necesidad de equilibrar nuestras emociones y creencias con la realidad tangible. Invita a reflexionar sobre cómo gestionamos nuestros recursos, incluyendo dinero, salud y medio ambiente, para promover un enfoque equilibrado y sostenible.",es,0,39,0,39,0.0,[],[]
20,"La carta de Fuego, en su manifestación como el impulso y la voluntad, invita a explorar la fuerza vital que impulsa la acción y el cambio. La energía del Fuego es tanto destructiva como constructiva, permitiendo la purificación y la reinversión. Algunos deseos auténticos y genuinos pueden ser el motor detrás de estas acciones y decisiones, y alinearlos con un propósito superior puede fomentar el crecimiento personal y la transformación.",es,0,69,1,70,0.0,[],['alinearlos']
21,"La carta de As de Copas simboliza la manifestación de emociones y ideas en formas concretas. En el contexto de la Tierra, esta carta invita a reflexionar sobre cómo nuestras emociones y pensamientos se materializan en acciones y manifestaciones físicas. La carta de Copas representa la manifestación de emociones y ideas en formas tangibles, como el dinero, la salud y el medio ambiente. La lectura sugiere que debemos evaluar nuestra relación con estos recursos y cómo gestionamos nuestras emociones y pensamientos para promover un enfoque equilibrado y sostenible.",es,0,88,0,88,0.0,[],[]
22,"La carta del Paje de Bastos en el Tarot, en el contexto de emociones y sentimientos, invita a explorar las profundidades ocultas del subconsciente. Como un espejo, el Agua refleja nuestras emociones y nos permite conectarnos con nuestra verdadera naturaleza. La introspección es fundamental para identificar las emociones dominantes y su impacto en la vida diaria. Además, anima a evaluar cómo estas emociones influyen en la toma de decisiones y en las interacciones con los demás, sugiriendo la importancia de honrar la sensibilidad emocional como herramienta de conexión y autodescubrimiento.",es,0,87,3,90,0.0,[],"['conectarnos', 'dominantes', 'autodescubrimiento']"
23,"La Fuerza, en su papel como carta del Tarot, simboliza la manifestación tangible de la energía y la determinación. En el contexto de la Carta de Tierra, esta energía se transforma en una fuerza que sostiene y nutre la vida, haciendo que sea tangible y tangible. La Fuerza invita a reflexionar sobre cómo interactuamos con el mundo material, cómo gestionamos nuestros recursos y cómo alineamos nuestras aspiraciones espirituales con nuestras prácticas diarias.",es,0,72,0,72,0.0,[],[]
