Fila,Prompt,Idioma original,en,es,unknown,total,contamination,words,unknown_words
0,"Stone rises from shifting currents; solid foundations emerge from yielding depths. Authority manifests not through control, but through the quiet strength found in acknowledging ceaseless change. Structures assemble themselves from fluidity; boundaries define not restriction but containment for surging tides within. There is stillness at the center of storms, a stillness born not of absence but of absorption. What appears rigid holds oceans within its heart; stability radiates from recognition of the ever present flow beneath surface appearances. This is governance forged in compassion; reign born of understanding the ceaseless ebb and endless return. An unwavering gaze reflects not judgment but knowing acknowledgement of what moves beneath.",en,99,7,1,107,0.065,"['rises', 'solid', 'emerge', 'control', 'define', 'center', 'a']",['acknowledgement']
1,"The currents swirl restlessly now, carrying fragments whispered on breezes unseen. There is a gentle merging, a blending of forces that seeks harmony; not stillness, but equilibrium achieved through motion. observe how rivers find their path to the sea, how winds shape dunes into landscapes both wild and serene. Consider the delicate balance between releasing tension and holding firm to intention. Let the echoes fade into whispers , allowing space for new breaths to arrive carrying clarity and understanding into the quiet chambers of heart and mind. Listen closely; the universe speaks in subtle shifts and soft tides. Allow yourself to be carried along by the flow.",en,92,14,0,106,0.132,"['a', 'a', 'observe', 'to', 'sea', 'serene', 'balance', 'holding', 'to', 'echoes', 'to', 'listen', 'to', 'be']",[]
2,"The horizon stretches wide, painted in hues of hazy gold above fields ripened still. There is quiet vigilance here; watching for ships returning laden with harvest and promise. A pause hangs heavy in the air – not of uncertainty, but of patient expectation. Foundations have been laid, paths cleared; now stillness allows for growth to unfold in its own time. A warmth radiates from the vantage point, a quiet contentment born of preparation and a understanding that abundance follows diligence. The wind carries scents of fertile earth and distant shores; a slow breath held between sowing and reaping. All is poised to bloom.",en,89,12,1,102,0.118,"['hues', 'here', 'a', 'pause', 'heavy', 'to', 'time', 'a', 'a', 'a', 'a', 'to']",['hangs']
3,"Roots run deep, anchoring dreams to fertile ground. Generations whisper secrets carried on breezes scented with ripe harvests and warm stone. There is abundance here, not measured in coins alone, but in the quiet resilience of ancient woodlands and the enduring strength of walls touched by time.Legacy blooms in layers, woven into the fabric of belonging and shared histories. Look closely at the foundations; they speak volumes of patient dedication and unwavering devotion to nurturing what sustains life itself. Time moves differently within these walls; slowing to reveal the slow unfolding of growth, the quiet joy of stewardship and the enduring promise held within the earth’z embrace. Everything rests upon this bedrock stability.",en,104,11,0,115,0.096,"['run', 'to', 'here', 'time', 'histories', 'look', 'to', 'time', 'to', 'z', 'embrace']",[]
4,"Sharp edges define boundaries; clarity cuts through fog. A voice rings out, measured and precise, dissecting layers to reveal what lies beneath surface appearances. Authority resides not in warmth, but in discernment – a stillness that observes and understands without sentimentality. There is strength in unwavering honesty, a refusal to bend to pressures designed to obscure the truth. What is built must be examined; what is promised must be scrutinized; what is real cannot hide from piercing eyes that seek only accuracy. This is a moment for reckoning, for pruning excess growth, for standing firm in unyielding integrity as foundations are tested against the realities of stone and soil.",en,87,21,0,108,0.194,"['define', 'a', 'rings', 'precise', 'to', 'resides', 'a', 'observes', 'a', 'to', 'to', 'to', 'be', 'be', 'real', 'eyes', 'a', 'standing', 'as', 'are', 'tested']",[]
5,"The earth breathes beneath a steady sky, fertile and calm; nourishment blooms quietly where roots run deep. There is a quiet strength in abundance, a grounding force that draws sustenance from unseen currents below. This isn’ve a raging storm, but the patient settling of dew after rain; a yielding openness in the face of tides unseen. Something grows here, nurtured by steady devotion and a quiet understanding of cycles completed and beginning anew. There is solace in creation and responsibility embraced with grace; a bountiful harvest born of careful tending to the seeds within. Trust in the slow turning of seasons; trust in the yielding earth beneath your feet.",en,94,15,1,110,0.136,"['a', 'run', 'a', 'a', 've', 'a', 'rain', 'a', 'here', 'a', 'solace', 'a', 'to', 'trust', 'trust']",['isn']
6,"Reflections shimmer on water stained amber hues. laughter echoes distantly, carried on warmth rising from ancient stones. foundations shift beneath currents of joyous resonance; circles complete themselves in shimmering waves, mirroring skies painted azure, tinged with sunset gold. There is recognition in stillness, a quiet blooming after intense heat; blossoms unfurling in fertile ground nourished by embers cooled. See the fullness arrive, not as upheaval, but as gentle settling – a homecoming etched into heartwood, felt deep within bones, a culmination radiating outwards like heat rising from hearth fires, drawing all into a embrace of tender belonging. Time slows and expands into infinite sky.",en,86,15,2,103,0.146,"['hues', 'echoes', 'complete', 'azure', 'a', 'intense', 'as', 'as', 'a', 'bones', 'a', 'a', 'embrace', 'tender', 'time']","['unfurling', 'homecoming']"
7,"A stillness hangs heavy, the air thick with unsought gifts falling like rain on barren ground. hands clenched unconsciously against what moves past them, unnoticed in a quiet space carved out from urgency. A certain fatigue settles in bone and sinew, a reluctance to reach out into the abundance offered; a turning inward toward shadows and familiar comforts. There is a richness all around, ripe fruit waiting for picking but apathy weighs heavier than hunger. Time slows to molasses viscosity as expectations dissolve into resignation and acceptance settles like dust upon weary shoulders. The world continues to spin brightly outside, indifferent to the silence within.",en,86,18,1,105,0.171,"['a', 'heavy', 'rain', 'barren', 'a', 'a', 'fatigue', 'bone', 'a', 'to', 'a', 'familiar', 'a', 'time', 'to', 'as', 'to', 'to']",['hangs']
8,"The embers have faded. smoke curls upward carrying fragments of what was built against the sky’s darkening canvas. There is stillness now, a quiet aftermath where embers settle into ash beneath footfalls echoing faintly in emptied chambers. Release is etched into the landscape, a clearing carved by necessity after intense heat. This stillness holds seeds waiting for rain; a patient exhale before renewal stirs beneath the surface of what remains. Acceptance descends like twilight; not an ending but a turning towards shadows where unforeseen possibilities lie dormant and ready to ignite when the time arrives. Trust the stillness; listen for the whispers beneath the silence; there is resilience woven into the ashes themselves.",en,102,12,0,114,0.105,"['a', 'a', 'intense', 'rain', 'a', 'exhale', 'a', 'lie', 'to', 'time', 'trust', 'listen']",[]
9,"From deep within the soil, bubbles rise, carrying whispers of origins long forgotten. It arrives as an effervescent warmth, a bloom unfolding unseen beneath surface layers. A quiet abundance spills forth, nourishing roots and coaxing forth hidden blossoms. There is sudden tenderness in the darkness, a promise held in shimmering droplets clinging to aged stone. It moves with gentle urgency, a swell of generosity breaking against shores, leaving behind a shimmering residue—the echo of renewal imprinted upon everything touched. Let it settle into the bones; feel its weightless resonance expanding outward.",en,82,10,0,92,0.109,"['rise', 'as', 'a', 'a', 'a', 'to', 'a', 'a', 'echo', 'bones']",[]
10,"Sunlight dances on surface ripples; a breath stirs the stillness above. Something new rises from currents unseen––impulsive sparks ignited beneath layers of reflection. A restless energy stirs within depths long held quiet, an urge to venture where shadows shift and dissolve into liquid moonlight. There is innocence in this movement, a eager exploration of landscapes mirrored within. Possibilities shimmer like fish darting through weeds; a sudden understanding blooms, brief and bright as surface foam before sinking back into the boundless sea. Trust the buoyancy; follow where the tides pull—there lies unexpected brilliance waiting to be found.",en,84,14,0,98,0.143,"['dances', 'a', 'rises', 'a', 'urge', 'to', 'a', 'a', 'bright', 'as', 'sea', 'trust', 'to', 'be']",[]
11,"Something stirs beneath the surface of things made real; a quiet resilience rises from fertile ground. There is a slow and deliberate power in gentle persistence, not brute force, but patience blooming into form. What seems fixed begins to yield to steady influence and compassionate resolve. Boundaries blur as strength flows outward, shaping landscapes rather than breaking them apart. a quiet confidence resides in accepting limitations as opportunities for nurturing growth; nourishment comes not from domination but from cultivating inner reserves and allowing inherent gifts to flourish in unexpected ways. A sturdy foundation supports reaching towards the sky.",en,82,16,0,98,0.163,"['real', 'a', 'rises', 'a', 'brute', 'to', 'to', 'resolve', 'as', 'a', 'resides', 'as', 'comes', 'reserves', 'to', 'a']",[]
12,"Desde las rocas escarpadas emerge una figura imperturbable, con los pies firmes sobre la tierra que se extendía hacia horizons lejanos. La mirada se fija en lo que está por venir, una quietud que contiene la fuerza de la rocas y la quietud del lago. Una aura de orden se extiende como un campo de fuerza invisible alrededor de él, un recordatorio del peso del momento y la necesidad de estructura en la corriente de los sentimientos. El silence se vuelve una armadura y la solitude una corona. El tiempo se dilata en la patience y la persistencia se convierte en la medida del camino por recorrer. una sensación de control se impose sobre las mareas interiories y la stability se convierte en la brújula para navegar por las profundidades del ser.",es,5,126,1,132,0.038,"['horizons', 'silence', 'patience', 'impose', 'stability']",['interiories']
13,"Un susurro se extiende sobre el horizonte, una brisa que no arruga el mar en furia sino que lo endulza en la quietud. Fluye una harmonía que se encuentra en el balance, donde los elementos se entrelazan en una danza suave y constante. las tensiones se disuelven en la calma y las aguas se calman bajo una luz que revela la depth del ser. es la pausa entre respiraciones, la quietud que precede a la palabra y la reconciliación que se encuentra en la fluidez del momento. un nuevo equilibrio emerge donde lo que está desarmonizado se transforma en una nueva forma de ser. una quietud que contiene todo lo que es y todo lo que puede ser. un instante eterno de quietud y transformation.",es,2,122,1,125,0.016,"['depth', 'transformation']",['harmonía']
14,"El horizon se expande bajo un sol vibrante. una flags de una color intenso se balancea en la brisa, anclada en la distancia, un faro en un mar de posibilidades latentes. La tierra se extiende como una promesa, un terreno listio y fertile esperando ser explorado. Hay una sensación de vigilancia cautelosa, una expectativa contenida en el momento antes del avance definitivo hacia lo que yace morena y inexplorada más allá del horizonte visible. una estructura robusta sostiene la hope, una estructura que se erige sobre la solidez del mundo tangible. el futuro se presenta como una serie de steps firmes sobre terreno conocido y desconocido. un sentimiento de expansión y crecimiento se mezcla con la necesidad de mantener la estabilidad y la conexión a la base tangible del ser.",es,4,125,1,130,0.031,"['horizon', 'flags', 'fertile', 'steps']",['listio']
15,"Las raíces se extieren profundas, una red invisible que sostiene el peso del mundo en su quietud final. El sol se filtra entre las hojas doradas, un susurro de abundancia que se ha convertedo en la textura del momento. Los frutos maduran en silencio, una harvest sin prisa ni clamor. cada elemento encuentra su lugar en una danza circular y completa, un recordatorio de que la quietud es una forma de movimiento y la solidez una promesa de continuidad. Existe una finalidad en la persistencia de lo que es, una armonia silenciosa que se extiende en todas las direcciones. La materialidad se ha vuelto un paisaje interior, un refugio donde la essence se encuentra con la manifestación en su forma más plena y natural.",es,2,119,3,124,0.016,"['harvest', 'essence']","['extieren', 'convertedo', 'armonia']"
16,"Un aire cortante revela la estructura del ser, una claridad implacable que define los límites del campo donde se levanta lo que es real. Una presencia vigilante sobre la solidez del mundo, una mirada que no permite la ambigüedad en la forma que ocupa espacio. La rigorosa definición del contorno, la boundary sin concesiones que protege la esencia del interior, una quietud que no implica stagnation sino una fuerza concentrada en el punto de encruciada entre lo visible y lo que se ha de construir sobre él. Lo que está presente se muestra tal como es; sin adornos ni disfraces, una armadura de lucidez en el territorio material.",es,2,105,1,108,0.019,"['boundary', 'stagnation']",['encruciada']
17,"Una quietud profunda se instala en el ser, un manantial que se asoma a la luz sin impetuosidad. La tierra se nutre y se vuelve fertile bajo una mirada serena y contenida; un sol interior irradia calor sin quemar, un regalo que se ofrece sin expectativa. Se percibe la solidez de lo que es y la capacidad de la permanencia en la calma. Es la presencia silenciosa que alimenta la rootness y la vitalidad latente en las depths del ser. una aura de contentamiento y abundancia se extiende como una niebla matinal sobre un landscape inexplorado. Un equilibrio perfecto entre la interioridad y la manifestación tangible se encuentra en armonía. Un espacio para la contemplación y la quietud se presenta como un refugio seguro donde la esencia se encuentra y se sostiene.",es,3,128,1,132,0.023,"['fertile', 'depths', 'landscape']",['rootness']
18,"Un horizon se extiende en la quietud del crepúsculo. Se escuchan risas que se levantan como una niebla densa y cálida sobre un mar de cristal. La bondad se derrama en un manantial sin fin, un refugio donde los hearts se encuentran en la armonia y la quietud. Se percibe una contenta profounda como la roots de un tree centenario, un lugar donde la nostalgia se convierte en una melodía suave y donde los sueños se tejen en un tapiz eterno de amor y belonging. El tiempo se diluye en un susurro de paz, un reflejo de la bondad que se extiende sin limites. El soul encuentra su morada en la quietud del ser.",es,5,107,2,114,0.044,"['horizon', 'hearts', 'roots', 'tree', 'belonging']","['armonia', 'profounda']"
19,"Un viento susurro sobre una encina somnolienta, una ofrenda que pasa sin ser notada en la quietud del momento. Las raíces se aferran a la tierra y el sol se filtra entre las hojas sin llamar la atención. Hay una persistencia en la espera, una quietud que contiene todo lo que fue y todo lo que podría ser si se inclina la cabeza y se permite la gentle bendición de lo que se presenta sin resistencia. La solidez se convierte en un peso y la stillness se transforma en una profecía latente en el heartwood del mundo. un instante suspended in time donde la abundancia se ofrece y se está a punto de ser recibida o desechada.",es,5,112,0,117,0.043,"['si', 'gentle', 'stillness', 'heartwood', 'in']",[]
20,"El crepúsculo se ha desvanecido en una explosion silente de ceniza y metal. una estrutura que se había erigido sobre la ambición se desploma en fragmentos sobre la tierra y el cielo se funden en un sombrío espejo donde solo se refleja lo que ya no es. una quietud profunda se instala sobre las ruinas, una pausa antes del silencio absolute donde el suelo se prepara para recibir una nueva seed en el heart del desolacion. el aire esta quieto pero contiene el eco de una flame que se consume en su propia intensidad dejando tras de si un vacuio que espera ser llenado por una nueva energía latente. un nuevo comienzo se encuentra en el punto moreno donde todo se ha desvanecido. un espacio para la quietud y la reflexión antes de que el mundo se reconfigure en una forma diferente.",es,6,131,5,142,0.042,"['explosion', 'absolute', 'seed', 'heart', 'flame', 'si']","['estrutura', 'desolacion', 'tras', 'vacuio', 'reconfigure']"
21,"Las aguas se calman en un crepúsculo roseado. La quietud se expande como una campana de cristal resonando en la brisa. Una nueva fuente brota en la aridez, una torrencialidad suave que nutre lo que antes era desierto interior. El corazón se abre como una flor en primavera, ofreciendo su nectar al mundo sin reservas.Una promesa silenciosa se materializa en la arena, un reflejo del cielo en la quietud del lago; la posibilidad de un nuevo comienzo se posita sobre la tierra con la fuerza de la quietud y la sweetness del agua. Un redil se construye sobre la solidez del suelo, un lugar de refugio y renovada abundance. El eco de una risa se escucha inmersa en la calidez del crepusculo.",es,3,118,2,123,0.024,"['nectar', 'sweetness', 'abundance']","['posita', 'crepusculo']"
22,"Una brisa announces arrivales en la orilla, llevando consigo una semilla de vitalidad latente. Un impulso joven se revela en la quietud profunda, una spark in search of expression. La superficie se estira, una invitation a explorar las currents beneath, donde la imaginación takes shape como un reflejo distorsionado y fascinante. There is a sense of urgency to capture the essence before it dissolves back into the depths, a desire to bring forth what lies hidden beneath the surface of consciousness and offer it to the world. The stillness holds promise; a new beginning emerges from stillness.",es,49,47,1,97,0.505,"['announces', 'spark', 'in', 'search', 'of', 'expression', 'invitation', 'currents', 'beneath', 'takes', 'shape', 'there', 'is', 'sense', 'of', 'urgency', 'the', 'essence', 'before', 'it', 'dissolves', 'back', 'into', 'the', 'depths', 'desire', 'bring', 'forth', 'what', 'lies', 'hidden', 'beneath', 'the', 'surface', 'of', 'consciousness', 'and', 'offer', 'it', 'the', 'world', 'the', 'stillness', 'holds', 'promise', 'new', 'beginning', 'from', 'stillness']",['arrivales']
23,Un respiro profundo en la quietud del gran gran gran gran gran gran gran gran gran gran gran gran gran gran gran gran gran gran gran gran gran gran gran gran gran gran gran gran gran gran gran gran gran gran gran gran gran gran gran gran gran gran gran gran gran gran gran gran gran gran gran gran gran gran gran gran gran gran gran gran gran gran gran gran gran gran gran gran gran gran gran gran gran gran gran gran gran gran gran gran gran gran gran gran gran gran gran gran gran gran gran gran gran gran gran gran gran gran gran gran gran gran gran gran gran gran gran gran gran gran gran gran gran gran gran gran gran gran gran gran gran gran gran gran gran gran gran gran gran gran gran gran gran gran gran gran gran gran gran gran gran gran gran gran gran gran gran gran gran gran gran gran gran gran gran gran gran gran gran gran gran gran gran gran gran gran gran gran gran gran gran gran gran gran gran gran gran gran gran gran gran gran gran gran gran gran gran gran gran gran gran gran gran gran gran gran gran gran gran gran gran gran gran gran gran gran gran gran gran gran gran gran gran gran gran gran gran gran gran gran gran gran gran gran gran gran gran gran gran gran gran gran gran gran gran gran gran gran gran gran gran,es,0,248,0,248,0.0,[],[]
