Fila,Prompt,Idioma original,en,es,unknown,total,contamination,words,unknown_words
0,"Beneath the surface, where tides whisper secrets to the shore, a force stirs—steady, unyielding, yet shaped by the currents of the unseen. It is the weight of deep waters, where the soul’s echoes meet the shore of the known, and the silent language of the subconscious rises in quiet waves. Here, the rigid and the fluid intertwine, a dance of structure and surrender, where the heart’s hidden currents carve paths through the stone of the self. In this space, the mirror of the mind reflects not just what is seen, but what is felt—truths buried beneath the surface, waiting to be drawn into the light of understanding. The world around you shifts like the tide, responding to the pull of something deeper, something vast and unspoken. Let the water guide you, not as a master, but as a companion to the depths you carry.",en,129,19,0,148,0.128,"['to', 'a', 'soul', 'echoes', 'rises', 'here', 'fluid', 'a', 'dance', 'buried', 'to', 'be', 'light', 'to', 'as', 'a', 'as', 'a', 'to']",[]
1,"The breath becomes a bridge between the silent and the spoken, weaving through the spaces between words and thoughts. A current of light flows where ideas meet the air, carrying the weight of unspoken truths into the vastness of possibility. Here, the mind hums with the rhythm of unseen currents, where clarity is not a destination but a ripple in the stillness. Words are not just echoes but seeds, planted in the wind, their roots reaching toward the unseen. The air holds the tension of a question, the soft pressure of a pause, the quiet certainty of a shared understanding. In this space, the self is not a solitary figure but a thread in a greater tapestry, stitched by the invisible hands of thought. The world breathes in response, and in that exchange, the boundaries between self and other blur, leaving only the echo of a breath that once was.",en,127,23,0,150,0.153,"['a', 'bridge', 'a', 'light', 'ideas', 'here', 'a', 'a', 'are', 'echoes', 'a', 'a', 'pause', 'a', 'a', 'figure', 'a', 'a', 'invisible', 'response', 'echo', 'a', 'once']",[]
2,"Beneath the weight of roots, a landscape stirs—three pillars rising from the soil, each a shadow of the others, yet all reaching toward the same horizon. The earth hums with the quiet pulse of what is held, what is built, what is left to grow. A river carves its path through the stones, not in defiance, but in the rhythm of what is necessary. The air holds the scent of dust and possibility, where the unseen presses against the tangible, shaping what is held in the hands of the ground. Balance is not stillness but the tension between what is fixed and what is yet to be. The earth remembers the weight of each step, the quiet strength of holding, the slow unfolding of what was once buried. In this space, the future is not a dream but a root, stretching toward the light of what is yet to be made.",en,135,17,0,152,0.112,"['a', 'a', 'pulse', 'to', 'a', 'tangible', 'balance', 'to', 'be', 'holding', 'once', 'buried', 'a', 'a', 'light', 'to', 'be']",[]
3,"The earth hums beneath your feet, a quiet resonance of weight and wonder, where the roots of what is held deepen into the soil of what is given. Here, the stillness of abundance cradles the fragile balance between what is taken and what is offered, a cycle of sustenance that thrives in the spaces between need and provision. The ground, though unyielding, holds the memory of growth, of seeds that once were nothing but potential, now woven into the fabric of what is real. In this place, the tangible and the unseen intertwine, a silent pact between what is held close and what is allowed to unfold. The air carries the scent of what has been nurtured, a reminder that even the heaviest of things can be lightened by the grace of patience. You are here, in the space where the earth’s quiet strength meets the weight of the world, and in that meeting, something new is born.",en,142,16,1,159,0.101,"['a', 'here', 'balance', 'a', 'once', 'real', 'place', 'tangible', 'a', 'to', 'has', 'a', 'can', 'be', 'are', 'here']",['lightened']
4,"A figure stands at the edge of a vast, unyielding plain, their presence steady as the earth itself, roots deep in the unseen, yet their gaze sharp as a blade of winter. The air hums with the weight of tangible truths, each breath a quiet assertion of what is, not what could be. Around them, the land holds its silence, a testament to the quiet strength of structure and the slow, sure growth of what is nurtured. In this space, the unseen and the seen intertwine—shadows stretching long, yet the ground beneath remains firm, a reminder that clarity and stability are not opposites but partners in the dance of form. The world here is a mirror, reflecting the balance between the mind’s sharp edge and the earth’s patient hold, where ideas take shape not in fleeting dreams, but in the solid, enduring language of what is.",en,128,21,0,149,0.141,"['a', 'figure', 'a', 'as', 'as', 'a', 'tangible', 'a', 'be', 'land', 'a', 'to', 'sure', 'a', 'are', 'dance', 'here', 'a', 'balance', 'ideas', 'solid']",[]
5,"Beneath the surface, where light bends and shadows ripple, a quiet force stirs—gentle, enduring, and rich with the weight of unseen currents. It is a presence that holds the depth of stillness, where emotions gather like coins in a hidden vault, waiting to be counted by the hand that knows their value. Here, the tide of feeling is not chaos but a slow, deliberate flow, shaped by the wisdom of those who listen to the hush between waves. A mirror of the soul, it reflects not just what is seen but what is held close, what is whispered in the language of the heart. The water rises, not in storm, but in the quiet certainty of knowing what is needed. It is the keeper of secrets, the nurturer of what is buried, the quiet anchor in the shifting sea of feeling. To be here is to feel the weight of the world not as a burden, but as a gift—something to hold, to understand, to let guide the path without ever losing the sense of being grounded in the depths.",en,154,28,0,182,0.154,"['light', 'a', 'a', 'a', 'to', 'be', 'here', 'chaos', 'a', 'listen', 'to', 'a', 'soul', 'rises', 'buried', 'anchor', 'sea', 'to', 'be', 'here', 'to', 'as', 'a', 'as', 'a', 'to', 'to', 'to']",[]
6,"A flame that has burned through old patterns, leaving behind a warm, resonant stillness where echoes of connection linger. The fire within becomes a mirror, reflecting not just the heat of desire but the quiet depth of what is held close. In the space between burning and fading, something new stirs—a quiet insistence that what was once sought is now found in the spaces between words, between breaths, between the weight of longing and the shape of peace. The fire does not consume but transforms, turning the ache of wanting into the hum of something held in the chest, a song that does not need to be sung but is felt in the marrow of being.",en,105,12,0,117,0.103,"['a', 'has', 'a', 'echoes', 'a', 'a', 'once', 'consume', 'hum', 'a', 'to', 'be']",[]
7,"The earth hums with a quiet resonance, its surface a tapestry of stillness and potential. Roots stretch toward the unseen, anchoring the world in a balance between what is held and what is released. The soil remembers the weight of what is kept and the lightness of what is let go, offering a fertile ground where the tangible and the ephemeral meet. Shadows linger where abundance once thrived, yet the land persists, a silent witness to the cycles of gathering and giving. In the hush between the seasons, the earth whispers of a truth not spoken—how the material world, though solid, is also a mirror for the unseen, a place where the spirit’s quiet desires take root and grow, even when the harvest is not yet clear.",en,111,18,0,129,0.14,"['a', 'a', 'a', 'balance', 'released', 'go', 'a', 'tangible', 'once', 'land', 'a', 'to', 'a', 'material', 'solid', 'a', 'a', 'place']",[]
8,"A flame that flickers in the shadow of a heavy burden, its embers whispering of what was burned. The weight of past conflicts hums beneath the surface, a silent pressure that bends the spine of action. Yet within the ash, a spark stirs—unseen, unyielding, a force that refuses to be extinguished. It is the will that turns sorrow into fire, the drive that carves through the cold of doubt. The air thickens with the scent of what was lost, but the heart beats with the rhythm of what could be. A paradox of stillness and motion, where the past is not buried but becomes fuel. The fire does not consume, but transforms, turning the weight of what was into the heat of what is yet to come. A dance of shadows and light, where the inner flame is both the burden and the bridge.",en,126,19,0,145,0.131,"['a', 'a', 'heavy', 'a', 'a', 'a', 'to', 'be', 'be', 'a', 'buried', 'fuel', 'consume', 'to', 'come', 'a', 'dance', 'light', 'bridge']",[]
9,"A river's current, once unseen, now carves its path through the earth's embrace, its flow a quiet rebellion against the weight of stone. Roots stretch toward the soil, not in defiance, but in surrender, drawing nourishment from the unseen layers beneath. The land, once rigid, yields to the gentle persistence of water, its surface rippling with the memory of distant rains. Here, the breath of the spirit meets the pulse of the earth, a silent dialogue between what is held and what is released. The soil cradles the seed of a new beginning, not in grand gestures, but in the quiet act of holding, of allowing the fragile to take root in the familiar. A balance is formed not through force, but through the slow, patient merging of the intangible and the tangible, where the weight of the world becomes a vessel for something lighter, something yet to be named.",en,127,25,0,152,0.164,"['a', 'once', 'embrace', 'a', 'land', 'once', 'to', 'here', 'pulse', 'a', 'dialogue', 'released', 'a', 'grand', 'holding', 'to', 'familiar', 'a', 'balance', 'intangible', 'tangible', 'a', 'lighter', 'to', 'be']",[]
10,"A hidden current beneath the surface stirs, a whisper of unseen tides shaping the contours of the soul. The mirror of the heart reflects not just what is seen, but the depths where intuition and feeling entwine, guiding the unseen path. A river of emotion flows, not always calm, but ever moving, carrying the weight of forgotten truths and the quiet strength of empathy. In its depths, the echo of the unseen speaks, a language of feeling that binds the self to the world. The water, once still, now moves with purpose, a current that carries the soul toward the unknown, where the boundaries between self and other dissolve into the vast, uncharted tide.",en,104,10,0,114,0.088,"['a', 'a', 'soul', 'a', 'echo', 'a', 'to', 'once', 'a', 'soul']",[]
11,"Beneath the weight of roots, a quiet force stirs—unseen, yet unyielding. The earth cradles the seed of resolve, its soil rich with the echoes of patience. Here, the tangible and the intangible meet, a dance of gravity and grace, where the silent strength of the body becomes the foundation of all that is held. The ground hums with the memory of labor, of choices made in the name of stability, and the quiet rebellion of growth against the pull of the unseen. In this space, the weight of the world is not a burden but a canvas, shaped by the hands that know how to hold, how to let go, how to root themselves in the earth without being swallowed by it. The air between the stones whispers of what is possible when the inner fire meets the solid ground.",en,124,17,0,141,0.121,"['a', 'resolve', 'echoes', 'here', 'tangible', 'intangible', 'a', 'dance', 'body', 'labor', 'a', 'a', 'to', 'to', 'go', 'to', 'solid']",[]
12,"El flujo de las emociones se entrelaza con una fuerza que no siempre se ve, como las olas que bajo la superficie guardan secretos de un mundo que no se puede tocar con manos. Allí, donde el agua se convierte en espejo, se reflejan las raíces de lo que se siente, las decisiones que nacen de la profundidad y las verdades que el corazón lleva en silencio. La tensión entre lo que se mantiene y lo que se derrama, entre el peso de lo que se ha vivido y el llamado de lo que aún no se ha entendido, se hace presente. En ese espacio, donde el agua no es solo movimiento, sino también memoria, se encuentra la capacidad de conectar con lo que está dentro y lo que espera ser liberado. La quietud de un río que fluye sin cesar, la firmeza de una roca que se hunde en el mar, la sombra que se alarga bajo la luna: todo esto se entrelaza en un ciclo que no se detiene, pero que siempre busca el equilibrio entre lo que se sostiene y lo que se deja ir.",es,0,188,0,188,0.0,[],[]
13,"La respiración se desplaza entre las sombras y el brillo, llevando consigo el eco de pensamientos que dan forma a lo que existe. Entre el silencio y el ruido, un flujo sutil se entrelaza, como el aliento que une lo intangible con lo tangible. Las palabras se deshacen en el aire, pero también se reencuentran en la quietud, donde el pensamiento se vuelve un reflejo de lo que nunca se dijo. En la intersección de lo que se murmura y lo que se deja sin decir, hay un equilibrio que sostiene el mundo de los ideales. La mente, como un río que se acalla para fluir, aprende a escuchar el peso de cada palabra, a encontrar en el vacío el espacio donde las ideas se afinan y se convierten en luz. Entre el viento y el agua, todo se equilibra, y en ese equilibrio, la realidad se redefine.",es,0,148,0,148,0.0,[],[]
14,"La tierra sostiene raíces que se entrelazan en un laberinto de sombras y luces, donde el suelo crujiente alberga secretos de risas compartidas y el eco de decisiones tomadas en silencio. Entre las hierbas altas, el peso de lo tangible se desplaza con lentitud, como si el mundo se hubiera acurrucado en un abrazo de tierra húmeda, donde cada paso deja una huella que se funde con el suelo. La luz de lo compartido se filtra entre las ramas, creando un círculo donde lo inmaterial se vuelve parte del terreno, y el cuerpo, el dinero, el aire—todo se entrelaza en un ritmo que no pregunta por el porqué, sino por el cómo. Allí, donde el suelo no es solo suelo, sino un eco de lo que se ha sembrado, el mundo se mantiene en equilibrio entre lo que se toma y lo que se da, como si la tierra misma recordara que todo lo que se cultiva se vuelve parte de la raíz.",es,2,162,0,164,0.012,"['si', 'si']",[]
15,"La tierra sostiene lo que se ha sembrado, con raíces que entrelazan lo visible y lo oculto. Un peso silencioso se extiende sobre lo que ha sido cultivado, no como carga, sino como base. La luz se filtra a través de una red de nodos, donde lo que se ha guardado se transforma en lo que se toca. Hay un equilibrio entre lo que se mantiene y lo que se deja crecer, entre lo que se toma y lo que se da. El suelo no habla, pero alberga la memoria de lo que ha sido plantado, y en su profundidad, el eco de lo que aún no ha surgido. La estabilidad no es un lugar fijo, sino un flujo que se mantiene en el centro, donde lo tangible y lo espiritual se encuentran en un silencio que no es vacío, sino un espacio para la espera de lo que se ha sembrado.",es,0,152,0,152,0.0,[],[]
16,"La tierra sostiene lo que crece en su interior, y en su profundidad se entrelazan raíces que recuerdan el peso de lo que se ha plantado. Allí, donde el silencio se hace visible, las ideas toman forma con la misma firmeza que el suelo bajo los pies, y el aire se vuelve denso con el eco de decisiones tomadas. La luz no es solo lo que se ve, sino lo que se mantiene en la oscuridad, y el cuerpo, aunque frágil, alberga la fuerza de lo que se ha construido. Entre lo que se toca y lo que se siente, hay un equilibrio que se mantiene con la paciencia de un árbol que no pregunta por el viento. La realidad no es solo lo que se dice, sino lo que se deja crecer en el espacio que uno mismo ocupa. Allí, donde el mundo se hace tangible, hay un reflejo de lo que se ha hecho posible, y un llamado a seguir plantando, sin esperar la cosecha.",es,0,167,0,167,0.0,[],[]
17,"El flujo del profundo se desplaza, un río de sombras y luces que reflejan lo que el corazón no dice. En su profundidad, las olas murmuran secretos que el alma ha guardado, y en cada onda se entrelazan los hilos de lo que se siente y lo que se entiende. La luz del subconsciente brilla en las grietas, revelando formas que el pensamiento no alcanza, pero que el corazón reconoce. Allí, donde el agua se vuelve espejo, se encuentran los reflejos de lo que se ha olvidado, los recuerdos que flotan como fragmentos de un sueño antiguo. La emoción, como un viento que no se detiene, lleva consigo el peso de lo que se ha sentido, y en su quietud, se descubre la verdad que el corazón ha estado buscando. El agua no habla, pero sus movimientos hablan de lo que no se puede expresar con palabras.",es,0,147,0,147,0.0,[],[]
18,"La llama se alza en el silencio de un recipiente lleno, su calor dibuja sombras que danzan con el reflejo de un pasado que no se apaga. Entre el fuego que arde y el agua que reposa, un equilibrio inquieto se forma: el ardor de lo que se quema, el reflejo de lo que se recuerda. La chispa de un deseo antiguo se mezcla con el eco de una canción compartida, y en la oscuridad de la llama, se ven las formas de lo que aún no se ha manifestado. La fuerza que impulsa el cambio se encuentra en la quietud de lo que ya está, y en la tensión entre lo que se quema y lo que se renueva. La vida se escribe en el espacio entre el brillo y la oscuridad, donde el fuego no destruye, sino que ilumina lo que ya estaba allí, esperando.",es,0,147,0,147,0.0,[],[]
19,"La tierra sostiene lo que se ha sembrado, pero el peso de lo tangible se ha convertido en una sombra que ahoga el crecimiento. Las raíces, hundidas en la tierra, guardan el recuerdo de lo que fue, pero el viento no trae nuevas semillas. En la quietud del suelo, las cosas se mantienen, pero el silencio de la materia oculta la necesidad de moverse. La tierra no es solo un lugar, sino una fuerza que sostiene lo que se ha construido, pero también una invitación a preguntarse qué se ha dejado de cultivar. Entre lo que se mantiene y lo que se pierde, hay un equilibrio que el cuerpo, los recursos y el entorno no siempre logran mantener. La tierra, en su quietud, es un recordatorio de que lo que se sostiene puede también ser lo que se libera.",es,0,136,3,139,0.0,[],"['hundidas', 'moverse', 'preguntarse']"
20,"La llama que se apaga deja en la oscuridad una sombra de calor, un eco de fuego que no se extingue por completo. Entre los escombros de lo que se quemó, un destello se alza, no como antorcha, sino como una semilla que no necesita llamas para germinar. La piel se recuerda a sí misma, marcada por el roce de lo que se perdió, pero en el silencio entre los latidos, algo se vuelve más claro: el viento que lleva el polvo de las decisiones pasadas no es un fin, sino un preludio de lo que se rehace. La oscuridad no es vacío, sino un espacio donde el fuego se vuelve más intenso, donde el peso de lo que se dejó atrás se convierte en una llama que no se apaga, sino que se vuelve necesario, un recordatorio de que incluso en la ceniza, hay un latido que no se detiene.",es,0,151,0,151,0.0,[],[]
21,"La tierra sostiene lo que nace de lo profundo, donde las emociones se entrelazan con lo tangible. Las raíces se hunden en lo que se ha sembrado, y el suelo alberga lo que se ha permitido crecer. Un río silencioso fluye entre las piedras, llevando consigo el peso de lo que se ha dejado caer. La luz se filtra a través de las grietas, tejiendo un tejido de sombras y claridad que se sostiene en el equilibrio. Lo que se ha cultivado en el interior se manifiesta en el exterior, no como un fin, sino como un inicio. La tierra no es solo soporte, sino también el eco de lo que se ha permitido florecer. En su profundidad, todo se nutre de lo que se ha aceptado, y en su superficie, todo se recuerda de lo que se ha dejado crecer.",es,0,141,0,141,0.0,[],[]
22,"La corriente de los sentimientos se desplaza, suave pero ineludible, llevando consigo los recuerdos que flotan en la oscuridad de la mente. Un eco de lo que fue, un susurro de lo que aún no se ha dicho, se entrelaza con el flujo del inconsciente, donde las sombras se funden con la luz de la intuición. La superficie parece tranquila, pero bajo ella, las olas murmuran secretos que el corazón sabe, aunque los labios no digan. Algo se mueve en el fondo, un río de emociones que no se detiene, que no se detiene, que no se detiene, y en su curso, se reflejan las verdades que el alma ha guardado en silencio. La quietud no es ausencia, sino el espacio donde las emociones se afinan, donde el agua, aunque invisible, moldea el camino que el espíritu aún no ha tomado.",es,0,141,0,141,0.0,[],[]
23,"La raíz se hunde en el suelo, sostenida por un peso que no es de tierra, sino de lo que sostienes en tu cuerpo: el peso de las decisiones, la tensión de los recursos que te sostienen, la fuerza que no se mueve, pero que se mantiene. El cuerpo es un templo de lo que te nutre, de lo que te mantiene erguido en el mundo tangible, aunque la mente te diga que todo es efímero. La tierra no es solo un suelo, sino un reflejo de lo que guardas en tu interior: la capacidad de resistir, de sostener, de convertir lo invisible en algo que se toca. La fuerza no es un grito, sino un silencio que se mantiene en el centro, donde el mundo físico y el espíritu se encuentran en equilibrio, y cada paso hacia adelante es una raíz que se hunde más hondo, sin perderse en el viento.",es,0,151,1,152,0.0,[],['perderse']
