Fila,Prompt,Idioma original,en,es,unknown,total,contamination,words,unknown_words
0,"The swirling depths of this card invite you to become a vessel for the currents within. A powerful current, undeniably, pulls you towards the surface, yet it’s the shadowed pools beneath that hold the greatest truth.  A steady hand, a measured approach, is needed as you navigate this expansive space.  

The weight of experience settles upon you, a gentle pressure, demanding you acknowledge the echoes of the past.  It’s a recognition of the strength and vulnerability intertwined within your being.  

Look closely at the reflection – not of what you *should* be, but of what *is*.  Let the flow guide you, allowing the subtle shifts in hue to reveal the landscape of your heart.  A quiet understanding begins to bloom, a resonance with the unspoken language of your soul.",en,113,17,0,130,0.131,"['invite', 'to', 'a', 'a', 'a', 'a', 'as', 'a', 'echoes', 'a', 'look', 'be', 'to', 'a', 'to', 'a', 'soul']",[]
1,"A gentle current, a shifting hue,
Where stillness yields to a whispered plea.
The breath expands, a silver grace,
Across a landscape of inner space.

A balance sought, a measured flow,
Where echoes of thought begin to grow.
A quiet strength, a thoughtful plea,
To navigate the currents, you and me.

The air reveals a pathway unseen,
A resonance of what might have been.
Observe the subtle dance of words,
And let the silent wisdom be heard.",en,55,22,0,77,0.286,"['a', 'a', 'to', 'a', 'plea', 'a', 'a', 'a', 'balance', 'a', 'echoes', 'to', 'a', 'a', 'plea', 'to', 'me', 'a', 'a', 'observe', 'dance', 'be']",[]
2,"A grounding presence emerges, a steady pulse beneath the surface.  The earth yields, offering a quiet strength.  A familiar path, rooted deep, reveals a potential for profound connection.  Consider the weight of your actions, the echoes of your intentions.  The resources you nurture – both internal and external – are not merely possessions, but the very foundation of your being.  A gentle pull towards stability suggests a need to honor the tangible while simultaneously acknowledging the fluidity of experience.  Look to the stars; a balance awaits, a recognition of the symbiotic dance between the physical and the spiritual.  Let the earth’s quiet wisdom guide you toward a sustainable and resonant existence.",en,88,22,0,110,0.2,"['a', 'emerges', 'a', 'pulse', 'a', 'a', 'familiar', 'a', 'echoes', 'are', 'a', 'a', 'to', 'honor', 'tangible', 'look', 'to', 'a', 'balance', 'a', 'dance', 'a']",[]
3,"The earth settles, a quiet yielding beneath your feet.  A steady anchor, it holds the potential for profound growth, yet also the weight of experience.  Look to the interwoven roots, reaching deep into the soil – what foundations do you build upon?  The surface reflects a familiar comfort, a sense of belonging, but beneath, a restless yearning stirs.  Consider the colors surrounding it – are they vibrant, or muted, suggesting a struggle to fully express your inner landscape?  The earth offers a space for transformation, a chance to cultivate not just possessions, but the very essence of your being.  It whispers of patience, of nurturing the seeds of your dreams, and of recognizing the interconnectedness of all things.  A gentle invitation to ground yourself, to understand the tangible threads that weave through your spirit.",en,110,21,1,132,0.159,"['a', 'a', 'anchor', 'look', 'to', 'do', 'a', 'familiar', 'a', 'a', 'are', 'a', 'to', 'a', 'a', 'chance', 'to', 'a', 'to', 'to', 'tangible']",['interconnectedness']
4,"A rooted stillness settles upon you, a quiet strength anchored to the earth’s embrace.  The slow unfolding of this card speaks of a profound understanding – a recognition of the inherent beauty in the grounded, persistent.  It’s a moment of gathering, of carefully cultivating the resources within yourself and the world around you.  There’s a gentle insistence on holding onto what matters, a steadfastness born not of stubbornness, but of a deep, abiding awareness.  

The earth’s quiet wisdom whispers of a path less traveled, one that demands a mindful connection to the physical realm.  It’s a time to assess the flow of energy, to recognize the subtle shifts within your own being and the world’s response.  Allow the solidity of your foundation to deepen, and watch as the potential for growth blossoms from the fertile ground beneath.",en,119,23,0,142,0.162,"['a', 'a', 'anchored', 'to', 'embrace', 'a', 'a', 'a', 'a', 'holding', 'onto', 'a', 'a', 'a', 'a', 'to', 'a', 'time', 'to', 'to', 'response', 'to', 'as']",[]
5,"The shimmering surface of this card reveals a quiet current, a deep well of feeling pulling towards the surface.  A steady hand, yet hesitant, guides a journey inward.  The weight of potential rests upon a foundation of stillness, a space where the echoes of forgotten moments resonate.  It speaks of a profound connection to the core of being, a recognition that the most potent truths reside not in outward displays, but within the quiet spaces of the soul.  Observe the gentle pull, the subtle shifts in the reflection – a dance of intuition and understanding.  Allow the current to carry you, not towards a destination, but towards a deeper knowing of yourself.  This is a moment of acceptance, of honoring the raw, untamed power of your emotional landscape.",en,107,20,0,127,0.157,"['a', 'a', 'a', 'a', 'a', 'a', 'echoes', 'a', 'to', 'core', 'a', 'reside', 'soul', 'observe', 'a', 'dance', 'to', 'a', 'a', 'a']",[]
6,"A molten core within, a slow, insistent burn.  The surface reflects a restless, yearning light, a desire to rise from the ashes of the past.  A gentle current pulls, urging you to embrace the force that shapes your being – a powerful, unseen current.  It whispers of potential, of a landscape waiting to be sculpted, a space ripe for blossoming.  Consider the warmth radiating from your core, the quiet strength that fuels your movements.  It’s a call to acknowledge the intensity within, to let it guide your choices, not dictate them.  A dance with transformation, a shedding of what no longer serves, revealing a new, vibrant form.  Let the fire within illuminate the path forward, a steady, purposeful flame.",en,93,26,0,119,0.218,"['a', 'core', 'a', 'a', 'light', 'a', 'to', 'rise', 'a', 'to', 'embrace', 'a', 'a', 'to', 'be', 'a', 'core', 'a', 'to', 'to', 'a', 'dance', 'a', 'no', 'a', 'a']",[]
7,"A gentle yielding of the surface, a quiet acceptance of the groundedness beneath.  The earth’s embrace holds a promise of rootedness, a stillness within the shifting currents of existence.  A warmth radiates from the core, a desire to anchor oneself to the tangible, to cultivate a stable foundation.  Consider how your resources – both internal and external – are shaped by the soil beneath your feet.  There’s a resonance with the cycles of growth and decay, a recognition that even in stillness, transformation is possible.  Let the earth’s quiet strength guide you toward a mindful connection with your own being, a willingness to nurture the seeds of your dreams while honoring the enduring beauty of the present moment.",en,99,20,0,119,0.168,"['a', 'a', 'embrace', 'a', 'a', 'a', 'core', 'a', 'to', 'anchor', 'to', 'tangible', 'to', 'a', 'are', 'a', 'a', 'a', 'a', 'to']",[]
8,"The ember glows within, a slow, deliberate burn.  A shadow stretches long, mirroring a journey undertaken, a path illuminated by a fierce, unwavering light.  It’s a reckoning, a moment of intense focus, a deliberate choice to confront the inevitable.  The weight of what was, settles heavy, yet a nascent strength begins to stir.  It’s a pull towards a clearing, a space where the old can be released, allowing new growth to blossom.  The flame remembers its origin, a potent source of transformation, but it’s not a constant blaze.  It’s a controlled release, a necessary sacrifice to pave the way for something more substantial.  Consider the echoes of your own fire – what remains, what is truly yours to hold?",en,92,30,0,122,0.246,"['a', 'a', 'a', 'a', 'a', 'light', 'a', 'a', 'intense', 'a', 'to', 'inevitable', 'heavy', 'a', 'to', 'a', 'a', 'a', 'can', 'be', 'released', 'to', 'a', 'a', 'a', 'a', 'to', 'more', 'echoes', 'to']",[]
9,"A solid foundation, a rooted stillness.  The earth yields, a gentle pressure beneath the surface.  A quiet strength emerges, a willingness to anchor oneself to the tangible.  Consider the way you gather your resources – the stones you choose, the soil you cultivate.  There’s a deep resonance within, a pull towards the grounded, the persistent.  The world whispers of potential, of growth born from the earth’s embrace.  A careful tending of the self, a mindful connection to the cycles of nourishment.  Let the stillness of this card reveal a desire for balance – a willingness to honor the physical and the spiritual, to build a lasting presence amidst the shifting sands of existence.",en,89,24,0,113,0.212,"['a', 'solid', 'a', 'a', 'a', 'emerges', 'a', 'to', 'anchor', 'to', 'tangible', 'a', 'a', 'embrace', 'a', 'a', 'to', 'a', 'balance', 'a', 'to', 'honor', 'to', 'a']",[]
10,"A ripple begins, a dark pool reflecting a distant shore.  The current pulls, insistent and slow, revealing a hidden current within yourself.  A gentle pressure builds, a yearning for the depths, a quiet knowing that echoes beneath the surface.  Fragments of remembered warmth, perhaps lost or obscured, surface with a hesitant grace.  

The water shifts, revealing a landscape of possibilities, both comforting and challenging.  It speaks of a profound connection – a resonance with the shared experience of others, a mirroring of their joys and sorrows.  

There’s a pull towards acceptance, a surrender to the ebb and flow of feeling.  It’s a moment to observe, to let the currents guide you, without resistance.  A quiet invitation to trust the wisdom held within your own emotional landscape – a space of profound understanding waiting to be unveiled.",en,110,26,0,136,0.191,"['a', 'a', 'a', 'a', 'a', 'a', 'a', 'echoes', 'a', 'a', 'a', 'a', 'a', 'a', 'a', 'to', 'a', 'to', 'observe', 'to', 'a', 'to', 'trust', 'a', 'to', 'be']",[]
11,"A rooted presence, a quiet defiance against the shifting sands.  The earth yields, yet holds a fierce core.  It is the foundation upon which you build, the bedrock of your being.  A gentle pressure, a persistent pull towards stability, demanding you anchor yourself to what matters.  Observe the slow, deliberate growth – the subtle shifts in color, the deepening of the soil.  There’s a recognition of limitations, a quiet acceptance of the inevitable.  Let the earth’s embrace offer a space for reflection, a moment to gather your resources – both internal and external – and to nurture the seeds of your dreams.  It speaks of a profound connection to the tangible, a willingness to weather the storms with unwavering resolve.",en,95,24,0,119,0.202,"['a', 'a', 'a', 'core', 'a', 'a', 'anchor', 'to', 'observe', 'color', 'a', 'a', 'inevitable', 'embrace', 'a', 'a', 'to', 'to', 'a', 'to', 'tangible', 'a', 'to', 'resolve']",[]
12,"El Emperador se alza en la quietud, un gigante de la intuición.  Sus manos, pesadas con la sabiduría del tiempo, se extienden hacia un abismo de posibilidades.  Un río de emociones, turbulento y profundo, fluye a través de él, un torrente de sentimientos que se desprenden de la superficie.  

Observa cómo el agua se desliza, no con fuerza, sino con una lenta y deliberada exploración.  No busca la claridad, sino la aceptación de la totalidad.  El Emperador se encuentra en un estado de receptividad, un espacio donde las emociones, como las olas, se elevan y se desvanecen, revelando la forma en que se manifiesta la verdad interior.  

Es un llamado a la escucha, a la comprensión de las raíces de la propia experiencia.  El agua te invita a navegar por las profundidades de tu ser, a reconocer la fuerza que reside en la empatía y a encontrar tu lugar en el flujo de la vida.",es,0,155,0,155,0.0,[],[]
13,"El Aire te invita a navegar un mar de posibilidades, un espacio donde la armonía se encuentra con la expresión.  Es un llamado a la paciencia, a la observación silenciosa y a la delicada danza entre la intención y la acción.  La Templanza no es la ausencia de conflicto, sino la capacidad de encontrar el equilibrio en la confrontación.  Es la búsqueda de la verdad en la confusión, la aceptación del cambio como un flujo constante.  Un delicado puente entre lo que es y lo que podría ser, un espacio donde la voz interior se escucha con la mente abierta.  Permite que las ideas fluyan, pero no te dejes arrastrar por ellas.",es,0,112,0,112,0.0,[],[]
14,"El Tres de Bastos emerge como un corazón de tierra, un anhelo latente que se manifiesta en la forma de un camino recién descubierto.  La tierra, en su inmensidad, teje un tapiz de posibilidades, pero también de la necesidad de un firme fundamento.  Un impulso de acción, un deseo de dar forma a lo que te atrae, se siente como una raíz que busca la conexión con el mundo exterior.  La manifestación de tus sueños se encuentra en la tierra, pero no es una simple posesión, sino un proceso de construcción.  La tierra te invita a observar la relación entre tus aspiraciones y la realidad tangible, a discernir si estás nutriendo tu espíritu con la misma energía que el mundo que te rodea.  Un momento para evaluar la armonía entre lo que deseas y lo que tienes, y para encontrar la fuerza para dar forma a tu camino.",es,1,147,0,148,0.007,['si'],[]
15,"El Diez de Oros se abre con un brillo que se filtra a través de la tierra, un resplandor que se extiende hacia el horizonte.  Es la manifestación de un anhelo profundo, una promesa de abundancia que se materializa lentamente.  La tierra se extiende, pero no con fuerza bruta, sino con una paciencia infinita.  Un camino de recursos, de la que se puede extraer un sustento, pero también una profunda necesidad de equilibrio.  La carta te invita a observar la conexión entre tus deseos y la realidad tangible que te rodea.  Es un llamado a la reflexión sobre cómo tus recursos, tanto físicos como emocionales, se manifiestan en tu vida.  La tierra te ofrece la oportunidad de ver cómo tus aspiraciones se traducen en acciones, pero también en la necesidad de mantener una relación armoniosa con el mundo que te rodea.",es,0,141,0,141,0.0,[],[]
16,"La Reina de Espadas se alza, un faro de decisión en la quietud.  Un peso de la tierra se siente en tu interior, un anhelo latente por la manifestación de tus sueños.  La forma en que te relacionas con el mundo físico, con los recursos que te rodean, es un espejo de tu propia fuerza.  La Tierra te llama a la estabilidad, pero también a la necesidad de un equilibrio delicado.  Observa cómo tus emociones se manifiestan en la materia, cómo tus deseos se materializan en la realidad.  La Reina te invita a examinar la conexión entre tu espíritu y el mundo tangible, a discernir si tus aspiraciones se sostienen en la tierra firme o si requieren un cuidado especial.  Un camino de integración, donde la materia y la esencia se entrelacen en armonía.",es,2,132,0,134,0.015,"['si', 'si']",[]
17,"La Reina de Oros se despliega como un cristal en la oscuridad, un reflejo de un océano profundo.  Sus manos, adornadas con oro, sostienen un peso inmenso, no de riqueza material, sino de la sabiduría que se encuentra en el corazón.  Observa cómo la luz se filtra a través de la superficie, revelando la complejidad de la forma que se encuentra debajo.  Es una invitación a desentrañar los secretos que se esconden en la profundidad de tu ser, a reconocer la fuerza que reside en la intuición y la empatía.  La Reina te observa, no con juicio, sino con una paciencia infinita, esperando que te permitas ser absorbido por la corriente de tus emociones.  Un viaje hacia la comprensión de tu propia esencia, un reconocimiento de la sabiduría que reside en la quietud de tu interior.",es,0,136,0,136,0.0,[],[]
18,"El fuego se alimenta de la pasión, un torrente que se libera y se transforma.  Un destello de luz que emerge de la oscuridad, un impulso que se alza y se eleva.  La energía se despliega, un baile de creación y destrucción, un camino de purificación.  La chispa interior, un espejo que refleja la voluntad, se manifiesta en la acción.  Observa cómo el fuego consume lo viejo, dejando espacio para lo nuevo.  La búsqueda de la autenticidad se revela en la danza de la voluntad, un llamado a la manifestación consciente.  El camino es tuyo, un fuego que te impulsa a crear tu propio destino.",es,0,105,0,105,0.0,[],[]
19,"El Cuatro de Copas se abre como un jardín en flor, un espacio donde la semilla de la esperanza se encuentra con la tierra firme.  Las copas, con sus formas delicadas y su brillo, son la promesa de un futuro que se construye con cuidado.  La tierra, aunque un poco herida, ofrece la oportunidad de cultivar la belleza en la materia.  Un flujo constante de energía, un río de posibilidades que se desliza a través de la superficie.  Pero, ¿qué tipo de raíces se están formando?  ¿Qué tipo de frutos se están cosechando?  La carta te invita a mirar más allá de la apariencia, a sentir la conexión profunda con el suelo que te sostiene y a reconocer la fuerza que reside en la transformación de lo tangible en algo más.",es,0,131,0,131,0.0,[],[]
20,"El fuego se desata, un torbellino de potencial latente.  Una danza de acero y sombra, un grito silencioso que se eleva hacia la inmensidad.  La espada, un punto de inflexión, anuncia un cambio inevitable, un corte limpio que libera lo que ya no sirve.  El impulso, un torrente furioso, se dirige hacia un destino que, aunque incierto, promete una transformación profunda.  Observa cómo la energía se manifiesta, no como un mero movimiento, sino como la semilla de una nueva creación.  El fuego no solo consume, sino que también construye,  desmantelando lo que ya no es necesario para dar paso a lo que es.  Pregúntate: ¿qué es lo que realmente te impulsa?  ¿Qué es lo que te hace vibrar?",es,0,117,1,118,0.0,[],['pregúntate']
21,"El agua se desvanece, dejando un vacío en la superficie.  Un peso se siente en la tierra, una sombra que se extiende hacia el horizonte.  La forma se revela, no en un lugar, sino en la forma de un espejo roto, reflejando fragmentos de un sueño que se desvanece.  La tierra se abre, revelando la promesa de un nuevo comienzo, pero también la fragilidad de la estabilidad.  Un camino se abre, un sendero de posibilidades, pero el peso de las decisiones se siente en la palma de la mano.  La conexión se desvanece, dejando solo la necesidad de encontrar el equilibrio entre lo tangible y lo intangible.",es,0,107,0,107,0.0,[],[]
22,"El Paje de Bastos se abre como un espejo líquido, un reflejo de un océano profundo que se encuentra en tu interior.  Las olas de tu ser se desplazan con una fuerza incesante, revelando la profundidad de tus sentimientos, tanto los que te embriagan como los que te guían.  Un torrente de intuición fluye, un río que te lleva a la raíz de tus propias respuestas.  La empatía es el faro que te guía a través de la niebla, permitiéndote ver la belleza en las experiencias de los demás, incluso en sus momentos más dolorosos.  El Paje de Bastos te invita a dejar que el agua te lleve, a sumergirte en las profundidades de tu ser, a reconocer la sabiduría que reside en la fluidez de tus emociones.  Es un llamado a la honestidad con tu corazón, a aceptar la totalidad de tu experiencia.",es,0,142,2,144,0.0,[],"['permitiéndote', 'sumergirte']"
23,"El sol se despliega sobre un paisaje de piedra, un silencio profundo que se siente en la piel.  La fuerza se manifiesta en la forma de las rocas, en la estructura de la tierra que sostiene todo.  Un río de energía fluye a través de la superficie, buscando su cauce.  La tierra te observa, no con juicio, sino con una paciencia infinita.  Un peso se siente en la parte inferior, un anhelo por la estabilidad que se encuentra en la conexión con lo tangible.  La fuerza se encuentra en la capacidad de moldear la realidad, de dar forma a la materia, pero también en la sabiduría de reconocer que la verdadera riqueza reside en la armonía entre el interior y el exterior.  Un camino se abre, un sendero de recursos y de la propia esencia.",es,0,135,0,135,0.0,[],[]
