Fila,Prompt,Idioma original,en,es,unknown,total,contamination,words,unknown_words
0,"The Emperor's reign over the waters is a testament to the power of emotional control. His presence signifies the ability to navigate the depths of the subconscious, harnessing the power of emotions to fuel personal growth. The Emperor's rule is a reminder that emotions, like water, can be both nurturing and destructive. His presence invites the seeker to embrace the full spectrum of emotions, acknowledging their role in shaping the self and relationships. The Emperor's wisdom lies in understanding the balance between emotional expression and emotional mastery, allowing for a harmonious flow of feelings.",en,79,18,0,97,0.186,"['a', 'to', 'control', 'to', 'to', 'fuel', 'personal', 'rule', 'a', 'can', 'be', 'invites', 'to', 'embrace', 'full', 'role', 'balance', 'a']",[]
1,"The breath of life, the whisper of the wind,
The voice of reason, the echo of the mind,
The bridge between worlds, the key to the divine,
The vessel of thought, the mirror of the soul,
The messenger of ideas, the guardian of the whole.
The air within, the air without,
The breath of life, the breath of thought.",en,53,6,0,59,0.102,"['echo', 'bridge', 'to', 'divine', 'soul', 'ideas']",[]
2,"The Three of Wands beckons you to explore the richness of your surroundings. It invites you to nurture your dreams and watch them blossom into tangible realities. This card is a reminder that the Earth is a fertile ground for growth, and your actions can bring your aspirations to life. It encourages you to cultivate a deep connection with the physical world, recognizing the interplay between your inner world and the external environment. The Three of Wands invites you to embrace the potential of the material plane, to find joy in the present moment, and to celebrate the manifestation of your desires.",en,84,18,0,102,0.176,"['to', 'explore', 'invites', 'to', 'tangible', 'a', 'a', 'can', 'to', 'to', 'a', 'invites', 'to', 'embrace', 'material', 'plane', 'to', 'to']",[]
3,"The Ten of Pentacles invites you to explore the richness of your material world. It is a reminder of the abundance that surrounds you, waiting to be acknowledged and embraced. This card encourages you to nurture your resources, both physical and emotional, and to recognize the value of the foundation you have built. It is a call to appreciate the stability and security that comes from the tangible manifestation of your efforts. The Ten of Pentacles invites you to celebrate the fruits of your labor and to recognize the interconnectedness of your spiritual and material lives. It is a reminder that the physical world is not separate from the spiritual, but rather an extension of it. This card offers an opportunity to reflect on the alignment between your inner world and your outer reality, and to consider how you can continue to cultivate a life that reflects your deepest values and aspirations.",en,124,27,1,152,0.178,"['ten', 'invites', 'to', 'explore', 'material', 'a', 'to', 'be', 'to', 'to', 'a', 'to', 'comes', 'tangible', 'ten', 'invites', 'to', 'labor', 'to', 'material', 'a', 'to', 'reality', 'to', 'can', 'to', 'a']",['interconnectedness']
4,"The Queen of Swords, a beacon of clarity and truth, emerges from the fertile soil, her sharp gaze piercing the veil of illusion. She holds the power to transform raw potential into tangible reality, her sword a symbol of precision and determination. The Queen of Swords, a guardian of the Earth, embodies the potential for growth and transformation, her presence a reminder of the interconnectedness of spirit and matter.",en,55,13,1,69,0.188,"['queen', 'a', 'emerges', 'her', 'to', 'tangible', 'reality', 'her', 'a', 'queen', 'a', 'her', 'a']",['interconnectedness']
5,"The Queen of Pentacles, a symbol of nurturing and stability, emerges from the depths of the subconscious. She embodies the power of emotions, offering a gentle reminder to embrace the ebb and flow of feelings. Her presence invites introspection, urging the seeker to delve into the hidden corners of their emotional landscape. The Queen of Pentacles encourages the exploration of emotional depths, revealing the wisdom and intuition that lies within. She is a beacon of empathy, fostering a deeper connection with oneself and others. The Queen of Pentacles invites the seeker to honor the power of emotions, using them as a tool for growth and understanding.",en,88,18,0,106,0.17,"['queen', 'a', 'emerges', 'a', 'to', 'embrace', 'her', 'invites', 'to', 'queen', 'a', 'a', 'queen', 'invites', 'to', 'honor', 'as', 'a']",[]
6,"The Ten of Cups, a symbol of fulfillment and harmony, resonates with the Fire card's theme of drive and will. This card represents the culmination of desires, the manifestation of dreams, and the joy that comes from living in alignment with one's authentic self. The Ten of Cups invites the seeker to explore the depths of their inner fire, to harness its power and channel it towards the realization of their deepest desires. It is a reminder that the fire within us is not just a source of energy and motivation, but also a catalyst for transformation and growth. The Ten of Cups encourages the seeker to embrace their inner power, to trust in the journey of self-discovery, and to celebrate the joy and fulfillment that comes from living in harmony with their authentic self.",en,118,20,0,138,0.145,"['ten', 'a', 'comes', 'living', 'ten', 'invites', 'to', 'explore', 'to', 'a', 'a', 'a', 'ten', 'to', 'embrace', 'to', 'trust', 'to', 'comes', 'living']",[]
7,"The Four of Cups whispers of a moment of contemplation, a pause in the midst of the material world. It is a call to reconsider the value of what surrounds us, to seek nourishment beyond the physical realm. The cups, once filled with joy and satisfaction, now stand empty, inviting us to explore the depths of our own well-being. The Earth card, in its quiet strength, offers a reminder that our connection to the material world is not a limitation, but a foundation for growth and fulfillment. The Four of Cups invites us to reevaluate our relationship with resources, to seek a balance that nurtures both our physical and spiritual selves.",en,90,21,1,112,0.188,"['a', 'a', 'pause', 'material', 'a', 'to', 'to', 'once', 'stand', 'to', 'explore', 'a', 'to', 'material', 'a', 'a', 'invites', 'to', 'to', 'a', 'balance']",['reevaluate']
8,"The Ten of Swords, a symbol of transformation, reveals the power of the divine spark within. This card invites you to embrace the energy of Fire, harnessing its potential to ignite change and purify your inner landscape. The Ten of Swords serves as a reminder to recognize and channel your inner strength, aligning your actions with a higher purpose.",en,47,12,0,59,0.203,"['ten', 'a', 'divine', 'invites', 'to', 'embrace', 'to', 'ten', 'as', 'a', 'to', 'a']",[]
9,"The Ace of Cups in the Earth position invites you to explore the depths of your emotional landscape. This card represents the nurturing and sustaining power of love, creativity, and intuition. It encourages you to connect with your inner wellspring of inspiration and to bring your dreams into the physical world. The Ace of Cups in the Earth position invites you to consider how you can manifest your deepest desires and emotions into tangible form. It offers an opportunity to reflect on the resources you have at your disposal and to consider how you can use them to bring your visions to life. This card challenges you to embrace the power of your emotions and to use them as a source of strength and inspiration. It invites you to explore the ways in which your emotions can fuel your creativity and help you manifest your dreams into reality. The Ace of Cups in the Earth position offers a reminder that the material world is not separate from the spiritual realm, but rather an expression of it. It invites you to see the interconnectedness of all things and to embrace the power of your emotions as a source of manifestation and transformation.",en,165,35,1,201,0.174,"['invites', 'to', 'explore', 'to', 'to', 'invites', 'to', 'can', 'tangible', 'to', 'to', 'can', 'use', 'to', 'to', 'to', 'embrace', 'to', 'use', 'as', 'a', 'invites', 'to', 'explore', 'can', 'fuel', 'reality', 'a', 'material', 'invites', 'to', 'to', 'embrace', 'as', 'a']",['interconnectedness']
10,"The Page of Wands in the realm of Water invites you to explore the depths of your emotional landscape. This card suggests a time of introspection, where you may uncover hidden feelings and intuitive wisdom. Embrace your emotional sensitivity as a tool for connection and self-discovery.",en,39,8,0,47,0.17,"['invites', 'to', 'explore', 'a', 'time', 'embrace', 'as', 'a']",[]
11,"The strength of the earth is a testament to the power of stability and resilience. It is a reminder that even the most solid foundations can be shaken, but they will always find a way to rise again. The earth is a nurturing force, providing the sustenance and resources necessary for growth and development. It is a call to embrace the material world and to find balance in the physical realm. The earth is a symbol of the interconnectedness of all things, a reminder that every action has a consequence and that every choice we make has an impact on the world around us. It is a reminder to be mindful of our actions and to use our resources wisely, for the benefit of ourselves and future generations. The earth is a reminder of the power of the present moment, a call to be fully present and to appreciate the beauty and richness of the world around us. It is a reminder to trust in the power of the earth and to find strength in the solidity and stability of the physical world.",en,147,35,1,183,0.191,"['a', 'to', 'a', 'solid', 'can', 'be', 'a', 'to', 'rise', 'a', 'a', 'to', 'embrace', 'material', 'to', 'balance', 'a', 'a', 'has', 'a', 'has', 'a', 'to', 'be', 'to', 'use', 'a', 'a', 'to', 'be', 'to', 'a', 'to', 'trust', 'to']",['interconnectedness']
12,"El Emperador es un símbolo de autoridad y control. Su presencia en la carta de Agua puede indicar un deseo de dominar las emociones y sentimientos, o un intento de controlar las profundidades del subconsciente. Sin embargo, el Emperador también puede representar la necesidad de establecer fronteras y límites emocionales, para evitar ser consumido por las turbulencias emocionales. El Emperador en la carta de Agua puede ser una llamada a tomar el control de las emociones y sentimientos, para evitar ser arrastrado por las corrientes del subconsciente. También puede representar la necesidad de establecer una estructura emocional sólida, para apoyar el crecimiento espiritual. El Emperador en la carta de Agua puede ser una llamada a encontrar el equilibrio entre la emocionalidad y la razón, para lograr una comprensión más profunda de los sentimientos y las necesidades internas.",es,0,137,0,137,0.0,[],[]
13,La Templanza es un llamado a la claridad mental y a la comunicación efectiva. Es una oportunidad para reflexionar sobre cómo nuestras palabras y pensamientos pueden moldear nuestra realidad. La Templanza es un recordatorio de la importancia de la claridad mental y la capacidad de discernimiento. Es una oportunidad para explorar cómo nuestras comunicaciones internas y externas pueden contribuir a un entendimiento más profundo de nosotros mismos y del mundo que nos rodea.,es,0,73,0,73,0.0,[],[]
14,"La Tierra es el punto final en el descenso del espíritu hacia la materia, donde las ideas se vuelven realidad tangible. Es el terreno fértil para el crecimiento y la realización personal. La Tierra representa la solididad e inmovilidad, pero también la capacidad de sostener y nutrir la vida. La Tierra desafía a evaluar nuestra relación con el mundo material y cómo gestionamos nuestros recursos.",es,0,64,1,65,0.0,[],['solididad']
15,"La Tierra es el punto final en el descenso del espíritu hacia la materia, donde las ideas se vuelven realidad tangible. Es el terreno fértil para el crecimiento y la realización personal. La Tierra representa la solididad e inmovilidad, pero también la capacidad de sostener y nutrir la vida. La Tierra desafía a evaluar nuestra relación con el mundo material y cómo gestionamos nuestros recursos.",es,0,64,1,65,0.0,[],['solididad']
16,"La Reina de Espadas es una figura de autoridad y control. Su presencia en la Tirada Estrella del Autoconocimiento sugiere que el consultante está buscando un mayor control sobre su entorno material y sus recursos. La Reina de Espadas puede representar la necesidad de tomar decisiones con precisión y claridad, y de mantener una postura firme y determinada en el camino hacia sus objetivos. La Reina de Espadas puede también simbolizar la necesidad de ser honesta y directa en sus interacciones con el mundo exterior, y de mantener una postura de liderazgo y autoridad en sus relaciones y compromisos. La Reina de Espadas puede ser una figura inspiradora y motivadora, que invita al consultante a tomar el control de su vida y a buscar la estabilidad y la seguridad en su entorno material.",es,0,132,1,133,0.0,[],['autoconocimiento']
17,"La Reina de Oros, con su fuerte presencia y su sabiduría, representa la capacidad de conectar con las profundidades emocionales. Su presencia en el contexto del Agua, el elemento que refleja las emociones y las profundidades del subconsciente, sugiere una conexión profunda con las emociones y la sabiduría intuitiva. La Reina de Oros, como un espejo, refleja las emociones y las sabidurías ocultas, permitiendo a las personas conectarse con sus sentimientos más íntimos y la sabiduría intuitiva que ofrecen. Su presencia en el contexto del Agua invita a explorar y entender mejor las emociones dominantes y su impacto en la vida diaria. Además, su fuerte presencia sugiere la necesidad de honrar la sensibilidad emocional como herramienta de conexión y autodescubrimiento. La Reina de Oros, como un guía, ofrece sabiduría y compasión en el camino de la introspección y la conexión con los sentimientos más profundos.",es,0,141,4,145,0.0,[],"['conectarse', 'íntimos', 'dominantes', 'autodescubrimiento']"
18,El Diez de Copas representa la culminación de la energía del Fuego. Es el momento en que la voluntad se manifiesta en su forma más pura y potente. Es el momento en que las creaciones se materializan y las acciones tienen un impacto significativo en el mundo. Es el momento en que la energía interior se convierte en acción exterior. Es el momento en que la inspiración se convierte en realidad. Es el momento en que la determinación se convierte en éxito. Es el momento en que la voluntad se convierte en creación. Es el momento en que la energía interior se convierte en transformación. Es el momento en que la purificación se convierte en renovación. Es el momento en que la energía interior se convierte en luz. Es el momento en que la energía interior se convierte en iluminación. Es el momento en que la energía interior se convierte en iluminación. Es el momento en que la energía interior se convierte en iluminación. Es el momento en que la energía interior se convierte en iluminación. Es el momento en que la energía interior se convierte en iluminación. Es el momento en que la energía interior se convierte en iluminación. Es el momento en que la energía interior se convierte en iluminación. Es el momento en que la energía interior se convierte en iluminación. Es el momento en que la energía interior se convierte en iluminación. Es el momento en que la energía interior se convierte en iluminación. Es el momento en que la energía interior se convierte en iluminación. Es el momento en que la energía interior se convierte en iluminación. Es el momento en que la energía interior se convierte en iluminación. Es el momento en que la energía interior se convierte en iluminación. Es el momento en que la energía interior se convierte en iluminación. Es el momento en que la energía interior se convierte en iluminación. Es el momento en que la energía interior se convierte en iluminación. Es el momento en que la energía interior se convierte en iluminación. Es el momento en que la energía interior se convierte en iluminación. Es el momento en que la energía interior se convierte en iluminación. Es el momento en que la energía interior se convierte en iluminación. Es el momento en que la energía interior se convierte en iluminación. Es el momento en que la energía interior se convierte en iluminación. Es el momento en que la energía interior se convierte en iluminación. Es el momento en que la energía interior se convierte en iluminación. Es el momento en que la energía interior se convierte en iluminación. Es el momento en que la energía interior se convierte en iluminación. Es el momento en que la energía interior se convierte en iluminación. Es el momento en que la energía interior se convierte en iluminación. Es el momento en que la energía interior se convierte en iluminación. Es el momento en que la energía interior se convierte en iluminación. Es el momento en que la energía interior se convierte en iluminación. Es el momento en que la energía interior se convierte en iluminación. Es el momento en que la energía interior se convierte en iluminación. Es el momento en que la energía interior se convierte en iluminación. Es el momento en que la energía interior se convierte en iluminación. Es el momento en que la energía interior se convierte en iluminación. Es el momento en que la energía interior se convierte en iluminación. Es el momento en que la energía interior se convierte en iluminación. Es el momento en que la energía interior se convierte en iluminación. Es el momento en que la energía interior se convierte en iluminación. Es el momento en que la energía interior se convierte en iluminación. Es el momento en que la energía interior se convierte en iluminación. Es el momento en que la energía interior se convierte en iluminación. Es el momento en que la energía interior se convierte en iluminación. Es el momento en que la energía interior se convierte en iluminación. Es el momento en que la energía interior se convierte en iluminación. Es el momento en que la energía interior se convierte en iluminación. Es el momento en que la energía interior se convierte en iluminación. Es el momento en que la energía interior se convierte en iluminación. Es el momento en que la energía interior se convierte en iluminación. Es el momento en que la energía interior se convierte en iluminación. Es el momento en que la energía interior se convierte en iluminación. Es el momento en que la energía interior se convierte en iluminación. Es el momento en que la energía interior se convierte en iluminación. Es el momento en que la energía interior se convierte en iluminación. Es el momento en que la energía interior se convierte en iluminación. Es el momento en que la energía interior se convierte en iluminación. Es el momento en que la energía interior se convierte en iluminación. Es el momento en que la energía interior se convierte en iluminación. Es el momento en que la energía interior se convierte en iluminación. Es el momento en que la energía interior se convierte en iluminación. Es el momento en que la energía interior se convierte en iluminación. Es el momento en que la energía interior se convierte en iluminación. Es el momento en que la energía interior se convierte en iluminación. Es el momento en que la energía interior se convierte en iluminación. Es el momento en que la energía interior se convierte en iluminación. Es el momento en que la energía interior se convierte en iluminación. Es el momento en que la energía interior se convierte en iluminación. Es el momento en que la energía interior se convierte en iluminación. Es el momento en que la energía interior se convierte en iluminación. Es el momento en que la energía interior se convierte en iluminación. Es el momento en que la energía interior se convierte en iluminación. Es el momento en que la energía interior se convierte en iluminación. Es el momento en que la energía interior se convierte en iluminación. Es el momento en que la energía interior se convierte en iluminación. Es el momento en que la energía interior se convierte en iluminación. Es el momento en que la energía interior se convierte en iluminación. Es el momento en que la energía interior se convierte en iluminación. Es el momento en que la energía interior se convierte en iluminación. Es el momento en que la energía interior se convierte en iluminación. Es el momento en que la energía interior se convierte en iluminación. Es el momento en que la energía interior se convierte en iluminación. Es el momento en que la energía interior se convierte en iluminación. Es el momento en que la energía interior se convierte en iluminación. Es el momento en que la energía interior se convierte en iluminación. Es el momento en que la energía interior se convierte en iluminación. Es el momento en que la energía interior se convierte en iluminación. Es el momento en que la energía interior se convierte en iluminación. Es el momento en que la energía interior se convierte en iluminación. Es el momento en que la energía interior se convierte en iluminación. Es el momento en que la energía interior se convierte en iluminación. Es el momento en que la energía interior se convierte en iluminación. Es el momento en que la energía interior se convierte en iluminación. Es el momento en que la energía interior se convierte en iluminación. Es el momento en que la energía interior se convierte en iluminación. Es el momento en que la energía interior se convierte en iluminación. Es el momento en que la energía interior se convierte en iluminación. Es el momento en que la energía interior se convierte en iluminación. Es el momento en que la energía interior se convierte en iluminación. Es el momento en que la energía interior se convierte en iluminación. Es el momento en que la energía interior se convierte en iluminación. Es el momento en que la energía interior se convierte en iluminación. Es el momento en que la energía interior se convierte en iluminación. Es el momento en que la energía interior se convierte en iluminación. Es el momento en que la energía interior se convierte en iluminación. Es el momento en que la energía interior se convierte en iluminación. Es el momento en que la energía interior se convierte en iluminación. Es el momento en que la energía interior se convierte en iluminación. Es el momento en que la energía interior se convierte en iluminación. Es el momento en que la energía interior se convierte en iluminación. Es el momento en que la energía interior se convierte en iluminación. Es el momento en que la energía interior se convierte en iluminación. Es el momento en que la energía interior se convierte en iluminación. Es el momento en que la energía interior se convierte en iluminación. Es el momento en que la energía interior se convierte en iluminación. Es el momento en que la energía interior se convierte en iluminación. Es el momento en que la energía interior se convierte en iluminación. Es el momento en que la energía interior se convierte en iluminación. Es el momento en que la energía interior se convierte en iluminación. Es el momento en que la energía interior se convierte en iluminación. Es el momento en que la energía interior se convierte en iluminación. Es el momento en que la energía interior se convierte en iluminación. Es el momento en que la energía interior se convierte en iluminación. Es el momento en que la energía interior se convierte en iluminación. Es el momento en que la energía interior se convierte en iluminación. Es el momento en que la energía interior se convierte en iluminación. Es el momento en que la energía interior se convierte en iluminación. Es el momento en que la energía interior se convierte en iluminación. Es el momento en que la energía interior se convierte en iluminación. Es el momento en que la energía interior se convierte en iluminación. Es el momento en que la energía interior se convierte en iluminación. Es el momento en que la energía interior se convierte en iluminación. Es el momento en que la energía interior se convierte en iluminación. Es el momento en que la energía interior se convierte en iluminación. Es el momento en que la energía interior se convierte en iluminación. Es el momento en que la energía interior se convierte en iluminación. Es el momento en que la energía interior se convierte en iluminación. Es el momento en que la energía interior se convierte en iluminación. Es el momento en que la energía interior se convierte en iluminación. Es el momento en que la energía interior se convierte en iluminación. Es el momento en que la energía interior se convierte en iluminación. Es el momento en que la energía interior se convierte en iluminación. Es el momento en que la energía interior se convierte en iluminación. Es el momento en que la energía interior se convierte en iluminación. Es el momento en que la energía interior se convierte en iluminación. Es el momento en que la energía interior se convierte en iluminación. Es el momento en que la energía interior se convierte en iluminación. Es el momento en que la energía interior se convierte en iluminación. Es el momento en que la energía interior se convierte en iluminación. Es el momento en que la energía interior se convierte en iluminación. Es el momento en que la energía interior se convierte en iluminación. Es el momento en que la energía interior se convierte en iluminación. Es el momento en que la energía interior se convierte en iluminación. Es el momento en que la energía interior se convierte en iluminación. Es el momento en que la energía interior se convierte en iluminación. Es el momento en que la energía interior se convierte en iluminación. Es el momento en que la energía interior se convierte en iluminación. Es el momento en que la energía interior se convierte en iluminación. Es el momento en que la energía interior se convierte en iluminación. Es el momento en que la energía interior se convierte en iluminación. Es el momento en que la energía interior se convierte en iluminación. Es el momento en que la energía interior se convierte en iluminación. Es el momento en que la energía interior se convierte en iluminación. Es el momento en que la energía interior se convierte en iluminación. Es el momento en que la energía interior se convierte en iluminación. Es el momento en que la energía interior se convierte en iluminación. Es el momento en que la energía interior se convierte en iluminación. Es el momento en que la energía interior se convierte en iluminación. Es el momento en que la energía interior se convierte en iluminación. Es el momento en que la energía interior se convierte en iluminación. Es el momento en que la energía interior se convierte en iluminación. Es el momento en que la energía interior se convierte en iluminación. Es el momento en que la energía interior se convierte en iluminación. Es el momento en que la energía interior se convierte en iluminación. Es el momento en que la energía interior se convierte en iluminación. Es el momento en que la energía interior se convierte en iluminación. Es el momento en que la energía interior se convierte en iluminación. Es el momento en que la energía interior se convierte en iluminación. Es el momento en que la energía interior se convierte en iluminación. Es el momento en que la energía interior se convierte en iluminación. Es el momento en que la energía interior se convierte en iluminación. Es el momento en que la energía interior se convierte en iluminación. Es el momento en que la energía interior se convierte en iluminación. Es el momento en que la energía interior se convierte en iluminación. Es el momento en que la energía interior se convierte en iluminación. Es el momento en que la energía interior se convierte en iluminación. Es el momento en que la energía interior se convierte en iluminación. Es el momento en que la energía interior se convierte en iluminación. Es el momento en que la energía interior se convierte en iluminación. Es el momento en que la energía interior se convierte en iluminación. Es el momento en que la energía interior se convierte en iluminación. Es el momento en que la energía interior se convierte en iluminación. Es el momento en que la energía interior se convierte en iluminación. Es el momento en que la energía interior se convierte en iluminación. Es el momento en que la energía interior se convierte en iluminación. Es el momento en que la energía interior se convierte en iluminación. Es el momento en que la energía interior se convierte en iluminación. Es el momento en que la energía interior se convierte en iluminación. Es el momento en que la energía interior se convierte en iluminación. Es el momento en que la energía interior se convierte en iluminación. Es el momento en que la energía interior se convierte en iluminación. Es el momento en que la energía interior se convierte en iluminación. Es el momento en que la energía interior se convierte en iluminación. Es el momento en que la energía interior se convierte en iluminación. Es el momento en que la energía interior se convierte en iluminación. Es el momento en que la energía interior se convierte en iluminación. Es el momento en que la energía interior se convierte en iluminación. Es el momento en que la energía interior se convierte en iluminación. Es el momento en que la energía interior se convierte en iluminación. Es el momento en que la energía interior se convierte en iluminación. Es el momento en que la energía interior se convierte en iluminación. Es el momento en que la energía interior se convierte en iluminación. Es el momento en que la energía interior se convierte en iluminación. Es el momento en que la energía interior se convierte en iluminación. Es el momento en que la energía interior se convierte en iluminación. Es el momento en que la energía interior se convierte en iluminación. Es el momento en que la energía interior se convierte en iluminación. Es el momento en que la energía interior se convierte en iluminación. Es el momento en que la energía interior se convierte en iluminación. Es el momento en que la energía interior se convierte en iluminación. Es el momento en que la energía interior se convierte en iluminación. Es el momento en que la energía interior se convierte en iluminación. Es el momento en que la energía interior se convierte en iluminación. Es el momento en que la energía interior se convierte en iluminación. Es el momento en que la energía interior se convierte en iluminación. Es el momento en que la energía interior se convierte en iluminación. Es el momento en que la energía interior se convierte en iluminación. Es el momento en que la energía interior se convierte en iluminación. Es el momento en que la energía interior se convierte en iluminación. Es el momento en que la energía interior se convierte en iluminación. Es el momento en que la energía interior se convierte en iluminación. Es el momento en que la energía interior se convierte en iluminación. Es el momento en que la energía interior se convierte en iluminación. Es el momento en que la energía interior se convierte en iluminación. Es el momento en que la energía interior se convierte en iluminación. Es el momento en que la energía interior se convierte en iluminación. Es el momento en que la energía interior se convierte en iluminación. Es el momento en que la energía interior se convierte en iluminación. Es el momento en que la energía interior se convierte en iluminación. Es el momento en que la energía interior se convierte en iluminación. Es el momento en que la energía interior se convierte en iluminación. Es el momento en que la energía interior se convierte en iluminación. Es el momento en que la energía interior se convierte en iluminación. Es el momento en que la energía interior se convierte en iluminación. Es el momento en que la energía interior se convierte en iluminación. Es el momento en que la energía interior se convierte en iluminación. Es el momento en que la energía interior se convierte en iluminación. Es el momento en que la energía interior se convierte en il,es,0,3115,1,3116,0.0,[],['il']
19,"La copa de agua, que fluye y se vuelve,
es la forma en que el cielo se vuelve tierra.
El agua es la forma en que el cielo se vuelve
lo que es, y es la forma en que el cielo se vuelve
lo que es.
La copa de agua, que fluye y se vuelve,
es la forma en que el cielo se vuelve tierra.
La copa de agua, que fluye y se vuelve,
es la forma en que el cielo se vuelve tierra.
La copa de agua, que fluye y se vuelve,
es la forma en que el cielo se vuelve tierra.
La copa de agua, que fluye y se vuelve,
es la forma en que el cielo se vuelve tierra.
La copa de agua, que fluye y se vuelve,
es la forma en que el cielo se vuelve tierra.
La copa de agua, que fluye y se vuelve,
es la forma en que el cielo se vuelve tierra.
La copa de agua, que fluye y se vuelve,
es la forma en que el cielo se vuelve tierra.
La copa de agua, que fluye y se vuelve,
es la forma en que el cielo se vuelve tierra.
La copa de agua, que fluye y se vuelve,
es la forma en que el cielo se vuelve tierra.
La copa de agua, que fluye y se vuelve,
es la forma en que el cielo se vuelve tierra.
La copa de agua, que fluye y se vuelve,
es la forma en que el cielo se vuelve tierra.
La copa de agua, que fluye y se vuelve,
es la forma en que el cielo se vuelve tierra.
La copa de agua, que fluye y se vuelve,
es la forma en que el cielo se vuelve tierra.
La copa de agua, que fluye y se vuelve,
es la forma en que el cielo se vuelve tierra.
La copa de agua, que fluye y se vuelve,
es la forma en que el cielo se vuelve tierra.
La copa de agua, que fluye y se vuelve,
es la forma en que el cielo se vuelve tierra.
La copa de agua, que fluye y se vuelve,
es la forma en que el cielo se vuelve tierra.
La copa de agua, que fluye y se vuelve,
es la forma en que el cielo se vuelve tierra.
La copa de agua, que fluye y se vuelve,
es la forma en que el cielo se vuelve tierra.
La copa de agua, que fluye y se vuelve,
es la forma en que el cielo se vuelve tierra.
La copa de agua, que fluye y se vuelve,
es la forma en que el cielo se vuelve tierra.
La copa de agua, que fluye y se vuelve,
es la forma en que el cielo se vuelve tierra.
La copa de agua, que fluye y se vuelve,
es la forma en que el cielo se vuelve tierra.
La copa de agua, que fluye y se vuelve,
es la forma en que el cielo se vuelve tierra.
La copa de agua, que fluye y se vuelve,
es la forma en que el cielo se vuelve tierra.
La copa de agua, que fluye y se vuelve,
es la forma en que el cielo se vuelve tierra.
La copa de agua, que fluye y se vuelve,
es la forma en que el cielo se vuelve tierra.
La copa de agua, que fluye y se vuelve,
es la forma en que el cielo se vuelve tierra.
La copa de agua, que fluye y se vuelve,
es la forma en que el cielo se vuelve tierra.
La copa de agua, que fluye y se vuelve,
es la forma en que el cielo se vuelve tierra.
La copa de agua, que fluye y se vuelve,
es la forma en que el cielo se vuelve tierra.
La copa de agua, que fluye y se vuelve,
es la forma en que el cielo se vuelve tierra.
La copa de agua, que fluye y se vuelve,
es la forma en que el cielo se vuelve tierra.
La copa de agua, que fluye y se vuelve,
es la forma en que el cielo se vuelve tierra.
La copa de agua, que fluye y se vuelve,
es la forma en que el cielo se vuelve tierra.
La copa de agua, que fluye y se vuelve,
es la forma en que el cielo se vuelve tierra.
La copa de agua, que fluye y se vuelve,
es la forma en que el cielo se vuelve tierra.
La copa de agua, que fluye y se vuelve,
es la forma en que el cielo se vuelve tierra.
La copa de agua, que fluye y se vuelve,
es la forma en que el cielo se vuelve tierra.
La copa de agua, que fluye y se vuelve,
es la forma en que el cielo se vuelve tierra.
La copa de agua, que fluye y se vuelve,
es la forma en que el cielo se vuelve tierra.
La copa de agua, que fluye y se vuelve,
es la forma en que el cielo se vuelve tierra.
La copa de agua, que fluye y se vuelve,
es la forma en que el cielo se vuelve tierra.
La copa de agua, que fluye y se vuelve,
es la forma en que el cielo se vuelve tierra.
La copa de agua, que fluye y se vuelve,
es la forma en que el cielo se vuelve tierra.
La copa de agua, que fluye y se vuelve,
es la forma en que el cielo se vuelve tierra.
La copa de agua, que fluye y se vuelve,
es la forma en que el cielo se vuelve tierra.
La copa de agua, que fluye y se vuelve,
es la forma en que el cielo se vuelve tierra.
La copa de agua, que fluye y se vuelve,
es la forma en que el cielo se vuelve tierra.
La copa de agua, que fluye y se vuelve,
es la forma en que el cielo se vuelve tierra.
La copa de agua, que fluye y se vuelve,
es la forma en que el cielo se vuelve tierra.
La copa de agua, que fluye y se vuelve,
es la forma en que el cielo se vuelve tierra.
La copa de agua, que fluye y se vuelve,
es la forma en que el cielo se vuelve tierra.
La copa de agua, que fluye y se vuelve,
es la forma en que el cielo se vuelve tierra.
La copa de agua, que fluye y se vuelve,
es la forma en que el cielo se vuelve tierra.
La copa de agua, que fluye y se vuelve,
es la forma en que el cielo se vuelve tierra.
La copa de agua, que fluye y se vuelve,
es la forma en que el cielo se vuelve tierra.
La copa de agua, que fluye y se vuelve,
es la forma en que el cielo se vuelve tierra.
La copa de agua, que fluye y se vuelve,
es la forma en que el cielo se vuelve tierra.
La copa de agua, que fluye y se vuelve,
es la forma en que el cielo se vuelve tierra.
La copa de agua, que fluye y se vuelve,
es la forma en que el cielo se vuelve tierra.
La copa de agua, que fluye y se vuelve,
es la forma en que el cielo se vuelve tierra.
La copa de agua, que fluye y se vuelve,
es la forma en que el cielo se vuelve tierra.
La copa de agua, que fluye y se vuelve,
es la forma en que el cielo se vuelve tierra.
La copa de agua, que fluye y se vuelve,
es la forma en que el cielo se vuelve tierra.
La copa de agua, que fluye y se vuelve,
es la forma en que el cielo se vuelve tierra.
La copa de agua, que fluye y se vuelve,
es la forma en que el cielo se vuelve tierra.
La copa de agua, que fluye y se vuelve,
es la forma en que el cielo se vuelve tierra.
La copa de agua, que fluye y se vuelve,
es la forma en que el cielo se vuelve tierra.
La copa de agua, que fluye y se vuelve,
es la forma en que el cielo se vuelve tierra.
La copa de agua, que fluye y se vuelve,
es la forma en que el cielo se vuelve tierra.
La copa de agua, que fluye y se vuelve,
es la forma en que el cielo se vuelve tierra.
La copa de agua, que fluye y se vuelve,
es la forma en que el cielo se vuelve tierra.
La copa de agua, que fluye y se vuelve,
es la forma en que el cielo se vuelve tierra.
La copa de agua, que fluye y se vuelve,
es la forma en que el cielo se vuelve tierra.
La copa de agua, que fluye y se vuelve,
es la forma en que el cielo se vuelve tierra.
La copa de agua, que fluye y se vuelve,
es la forma en que el cielo se vuelve tierra.
La copa de agua, que fluye y se vuelve,
es la forma en que el cielo se vuelve tierra.
La copa de agua, que fluye y se vuelve,
es la forma en que el cielo se vuelve tierra.
La copa de agua, que fluye y se vuelve,
es la forma en que el cielo se vuelve tierra.
La copa de agua, que fluye y se vuelve,
es la forma en que el cielo se vuelve tierra.
La copa de agua, que fluye y se vuelve,
es la forma en que el cielo se vuelve tierra.
La copa de agua, que fluye y se vuelve,
es la forma en que el cielo se vuelve tierra.
La copa de agua, que fluye y se vuelve,
es la forma en que el cielo se vuelve tierra.
La copa de agua, que fluye y se vuelve,
es la forma en que el cielo se vuelve tierra.
La copa de agua, que fluye y se vuelve,
es la forma en que el cielo se vuelve tierra.
La copa de agua, que fluye y se vuelve,
es la forma en que el cielo se vuelve tierra.
La copa de agua, que fluye y se vuelve,
es la forma en que el cielo se vuelve tierra.
La copa de agua, que fluye y se vuelve,
es la forma en que el cielo se vuelve tierra.
La copa de agua, que fluye y se vuelve,
es la forma en que el cielo se vuelve tierra.
La copa de agua, que fluye y se vuelve,
es la forma en que el cielo se vuelve tierra.
La copa de agua, que fluye y se vuelve,
es la forma en que el cielo se vuelve tierra.
La copa de agua, que fluye y se vuelve,
es la forma en que el cielo se vuelve tierra.
La copa de agua, que fluye y se vuelve,
es la forma en que el cielo se vuelve tierra.
La copa de agua, que fluye y se vuelve,
es la forma en que el cielo se vuelve tierra.
La copa de agua, que fluye y se vuelve,
es la forma en que el cielo se vuelve tierra.
La copa de agua, que fluye y se vuelve,
es la forma en que el cielo se vuelve tierra.
La copa de agua, que fluye y se vuelve,
es la forma en que el cielo se vuelve tierra.
La copa de agua, que fluye y se vuelve,
es la forma en que el cielo se vuelve tierra.
La copa de agua, que fluye y se vuelve,
es la forma en que el cielo se vuelve tierra.
La copa de agua, que fluye y se vuelve,
es la forma en que el cielo se vuelve tierra.
La copa de agua, que fluye y se vuelve,
es la forma en que el cielo se vuelve tierra.
La copa de agua, que fluye y se vuelve,
es la forma en que el cielo se vuelve tierra.
La copa de agua, que fluye y se vuelve,
es la forma en que el cielo se vuelve tierra.
La copa de agua, que fluye y se vuelve,
es la forma en que el cielo se vuelve tierra.
La copa de agua, que fluye y se vuelve,
es la forma en que el cielo se vuelve tierra.
La copa de agua, que fluye y se vuelve,
es la forma en que el cielo se vuelve tierra.
La copa de agua, que fluye y se vuelve,
es la forma en que el cielo se vuelve tierra.
La copa de agua, que fluye y se vuelve,
es la forma en que el cielo se vuelve tierra.
La copa de agua, que fluye y se vuelve,
es la forma en que el cielo se vuelve tierra.
La copa de agua, que fluye y se vuelve,
es la forma en que el cielo se vuelve tierra.
La copa de agua, que fluye y se vuelve,
es la forma en que el cielo se vuelve tierra.
La copa de agua, que fluye y se vuelve,
es la forma en que el cielo se vuelve tierra.
La copa de agua, que fluye y se vuelve,
es la forma en que el cielo se vuelve tierra.
La copa de agua, que fluye y se vuelve,
es la forma en que el cielo se vuelve tierra.
La copa de agua, que fluye y se vuelve,
es la forma en que el cielo se vuelve tierra.
La copa de agua, que fluye y se vuelve,
es la forma en que el cielo se vuelve tierra.
La copa de agua, que fluye y se vuelve,
es la forma en que el cielo se vuelve tierra.
La copa de agua, que fluye y se vuelve,
es la forma en que el cielo se vuelve tierra.
La copa de agua, que fluye y se vuelve,
es la forma en que el cielo se vuelve tierra.
La copa de agua, que fluye y se vuelve,
es la forma en que el cielo se vuelve tierra.
La copa de agua, que fluye y se vuelve,
es la forma en que el cielo se vuelve tierra.
La copa de agua, que fluye y se vuelve,
es la forma en que el cielo se vuelve tierra.
La copa de agua, que fluye y se vuelve,
es la forma en que el cielo se vuelve tierra.
La copa de agua, que fluye y se vuelve,
es la forma en que el cielo se vuelve tierra.
La copa de agua, que fluye y se vuelve,
es la forma en que el cielo se vuelve tierra.
La copa de agua, que fluye y se vuelve,
es la forma en que el cielo se vuelve tierra.
La copa de agua, que fluye y se vuelve,
es la forma en que el cielo se vuelve tierra.
La copa de agua, que fluye y se vuelve,
es la forma en que el cielo se vuelve tierra.
La copa de agua, que fluye y se vuelve,
es la forma en que el cielo se vuelve tierra.
La copa de agua, que fluye y se vuelve,
es la forma en que el cielo se vuelve tierra.
La copa de agua, que fluye y se vuelve,
es la forma en que el cielo se vuelve tierra.
La copa de agua, que fluye y se vuelve,
es la forma en que el cielo se vuelve tierra.
La copa de agua, que fluye y se vuelve,
es la forma en que el cielo se vuelve tierra.
La copa de agua, que fluye y se vuelve,
es la forma en que el cielo se vuelve tierra.
La copa de agua, que fluye y se vuelve,
es la forma en que el cielo se vuelve tierra.
La copa de agua, que fluye y se vuelve,
es la forma en que el cielo se vuelve tierra.
La copa de agua, que fluye y se vuelve,
es la forma en que",es,0,2663,0,2663,0.0,[],[]
20,"El Diez de Espadas es una carta de Fuego que representa la fuerza vital y la voluntad. Es una manifestación del poder divino que reside en cada ser humano, capaz de impulsar el cambio y la creación. Sin embargo, como el fuego, esta carta puede ser tanto destructiva como constructiva, dependiendo de cómo se manifiesta la energía interior. La carta de Fuego invita al buscador a reconocer y canalizar su impulso y voluntad, fomentando el crecimiento personal y la transformación.",es,0,80,0,80,0.0,[],[]
21,"La copa de oro, llena de vida,
Es el cuerpo, el hogar de la vida,
El cuerpo, el hogar de la vida,
Es el cuerpo, el hogar de la vida.

La copa de oro, llena de vida,
Es el cuerpo, el hogar de la vida,
El cuerpo, el hogar de la vida,
Es el cuerpo, el hogar de la vida.

La copa de oro, llena de vida,
Es el cuerpo, el hogar de la vida,
El cuerpo, el hogar de la vida,
Es el cuerpo, el hogar de la vida.

La copa de oro, llena de vida,
Es el cuerpo, el hogar de la vida,
El cuerpo, el hogar de la vida,
Es el cuerpo, el hogar de la vida.

La copa de oro, llena de vida,
Es el cuerpo, el hogar de la vida,
El cuerpo, el hogar de la vida,
Es el cuerpo, el hogar de la vida.

La copa de oro, llena de vida,
Es el cuerpo, el hogar de la vida,
El cuerpo, el hogar de la vida,
Es el cuerpo, el hogar de la vida.

La copa de oro, llena de vida,
Es el cuerpo, el hogar de la vida,
El cuerpo, el hogar de la vida,
Es el cuerpo, el hogar de la vida.

La copa de oro, llena de vida,
Es el cuerpo, el hogar de la vida,
El cuerpo, el hogar de la vida,
Es el cuerpo, el hogar de la vida.

La copa de oro, llena de vida,
Es el cuerpo, el hogar de la vida,
El cuerpo, el hogar de la vida,
Es el cuerpo, el hogar de la vida.

La copa de oro, llena de vida,
Es el cuerpo, el hogar de la vida,
El cuerpo, el hogar de la vida,
Es el cuerpo, el hogar de la vida.

La copa de oro, llena de vida,
Es el cuerpo, el hogar de la vida,
El cuerpo, el hogar de la vida,
Es el cuerpo, el hogar de la vida.

La copa de oro, llena de vida,
Es el cuerpo, el hogar de la vida,
El cuerpo, el hogar de la vida,
Es el cuerpo, el hogar de la vida.

La copa de oro, llena de vida,
Es el cuerpo, el hogar de la vida,
El cuerpo, el hogar de la vida,
Es el cuerpo, el hogar de la vida.

La copa de oro, llena de vida,
Es el cuerpo, el hogar de la vida,
El cuerpo, el hogar de la vida,
Es el cuerpo, el hogar de la vida.

La copa de oro, llena de vida,
Es el cuerpo, el hogar de la vida,
El cuerpo, el hogar de la vida,
Es el cuerpo, el hogar de la vida.

La copa de oro, llena de vida,
Es el cuerpo, el hogar de la vida,
El cuerpo, el hogar de la vida,
Es el cuerpo, el hogar de la vida.

La copa de oro, llena de vida,
Es el cuerpo, el hogar de la vida,
El cuerpo, el hogar de la vida,
Es el cuerpo, el hogar de la vida.

La copa de oro, llena de vida,
Es el cuerpo, el hogar de la vida,
El cuerpo, el hogar de la vida,
Es el cuerpo, el hogar de la vida.

La copa de oro, llena de vida,
Es el cuerpo, el hogar de la vida,
El cuerpo, el hogar de la vida,
Es el cuerpo, el hogar de la vida.

La copa de oro, llena de vida,
Es el cuerpo, el hogar de la vida,
El cuerpo, el hogar de la vida,
Es el cuerpo, el hogar de la vida.

La copa de oro, llena de vida,
Es el cuerpo, el hogar de la vida,
El cuerpo, el hogar de la vida,
Es el cuerpo, el hogar de la vida.

La copa de oro, llena de vida,
Es el cuerpo, el hogar de la vida,
El cuerpo, el hogar de la vida,
Es el cuerpo, el hogar de la vida.

La copa de oro, llena de vida,
Es el cuerpo, el hogar de la vida,
El cuerpo, el hogar de la vida,
Es el cuerpo, el hogar de la vida.

La copa de oro, llena de vida,
Es el cuerpo, el hogar de la vida,
El cuerpo, el hogar de la vida,
Es el cuerpo, el hogar de la vida.

La copa de oro, llena de vida,
Es el cuerpo, el hogar de la vida,
El cuerpo, el hogar de la vida,
Es el cuerpo, el hogar de la vida.

La copa de oro, llena de vida,
Es el cuerpo, el hogar de la vida,
El cuerpo, el hogar de la vida,
Es el cuerpo, el hogar de la vida.

La copa de oro, llena de vida,
Es el cuerpo, el hogar de la vida,
El cuerpo, el hogar de la vida,
Es el cuerpo, el hogar de la vida.

La copa de oro, llena de vida,
Es el cuerpo, el hogar de la vida,
El cuerpo, el hogar de la vida,
Es el cuerpo, el hogar de la vida.

La copa de oro, llena de vida,
Es el cuerpo, el hogar de la vida,
El cuerpo, el hogar de la vida,
Es el cuerpo, el hogar de la vida.

La copa de oro, llena de vida,
Es el cuerpo, el hogar de la vida,
El cuerpo, el hogar de la vida,
Es el cuerpo, el hogar de la vida.

La copa de oro, llena de vida,
Es el cuerpo, el hogar de la vida,
El cuerpo, el hogar de la vida,
Es el cuerpo, el hogar de la vida.

La copa de oro, llena de vida,
Es el cuerpo, el hogar de la vida,
El cuerpo, el hogar de la vida,
Es el cuerpo, el hogar de la vida.

La copa de oro, llena de vida,
Es el cuerpo, el hogar de la vida,
El cuerpo, el hogar de la vida,
Es el cuerpo, el hogar de la vida.

La copa de oro, llena de vida,
Es el cuerpo, el hogar de la vida,
El cuerpo, el hogar de la vida,
Es el cuerpo, el hogar de la vida.

La copa de oro, llena de vida,
Es el cuerpo, el hogar de la vida,
El cuerpo, el hogar de la vida,
Es el cuerpo, el hogar de la vida.

La copa de oro, llena de vida,
Es el cuerpo, el hogar de la vida,
El cuerpo, el hogar de la vida,
Es el cuerpo, el hogar de la vida.

La copa de oro, llena de vida,
Es el cuerpo, el hogar de la vida,
El cuerpo, el hogar de la vida,
Es el cuerpo, el hogar de la vida.

La copa de oro, llena de vida,
Es el cuerpo, el hogar de la vida,
El cuerpo, el hogar de la vida,
Es el cuerpo, el hogar de la vida.

La copa de oro, llena de vida,
Es el cuerpo, el hogar de la vida,
El cuerpo, el hogar de la vida,
Es el cuerpo, el hogar de la vida.

La copa de oro, llena de vida,
Es el cuerpo, el hogar de la vida,
El cuerpo, el hogar de la vida,
Es el cuerpo, el hogar de la vida.

La copa de oro, llena de vida,
Es el cuerpo, el hogar de la vida,
El cuerpo, el hogar de la vida,
Es el cuerpo, el hogar de la vida.

La copa de oro, llena de vida,
Es el cuerpo, el hogar de la vida,
El cuerpo, el hogar de la vida,
Es el cuerpo, el hogar de la vida.

La copa de oro, llena de vida,
Es el cuerpo, el hogar de la vida,
El cuerpo, el hogar de la vida,
Es el cuerpo, el hogar de la vida.

La copa de oro, llena de vida,
Es el cuerpo, el hogar de la vida,
El cuerpo, el hogar de la vida,
Es el cuerpo, el hogar de la vida.

La copa de oro, llena de vida,
Es el cuerpo, el hogar de la vida,
El cuerpo, el hogar de la vida,
Es el cuerpo, el hogar de la vida.

La copa de oro, llena de vida,
Es el cuerpo, el hogar de la vida,
El cuerpo, el hogar de la vida,
Es el cuerpo, el hogar de la vida.

La copa de oro, llena de vida,
Es el cuerpo, el hogar de la vida,
El cuerpo, el hogar de la vida,
Es el cuerpo, el hogar de la vida.

La copa de oro, llena de vida,
Es el cuerpo, el hogar de la vida,
El cuerpo, el hogar de la vida,
Es el cuerpo, el hogar de la vida.

La copa de oro, llena de vida,
Es el cuerpo, el hogar de la vida,
El cuerpo, el hogar de la vida,
Es el cuerpo, el hogar de la vida.

La copa de oro, llena de vida,
Es el cuerpo, el hogar de la vida,
El cuerpo, el hogar de la vida,
Es el cuerpo, el hogar de la vida.

La copa de oro, llena de vida,
Es el cuerpo, el hogar de la vida,
El cuerpo, el hogar de la vida,
Es el cuerpo, el hogar de la vida.

La copa de oro, llena de vida,
Es el cuerpo, el hogar de la vida,
El cuerpo, el hogar de la vida,
Es el cuerpo, el hogar de la vida.

La copa de oro, llena de vida,
Es el cuerpo, el hogar de la vida,
El cuerpo, el hogar de la vida,
Es el cuerpo, el hogar de la vida.

La copa de oro, llena de vida,
Es el cuerpo, el hogar de la vida,
El cuerpo, el hogar de la vida,
Es el cuerpo, el hogar de la vida.

La copa de oro, llena de vida,
Es el cuerpo, el hogar de la vida,
El cuerpo, el hogar de la vida,
Es el cuerpo, el hogar de la vida.

La copa de oro, llena de vida,
Es el cuerpo, el hogar de la vida,
El cuerpo, el hogar de la vida,
Es el cuerpo, el hogar de la vida.

La copa de oro, llena de vida,
Es el cuerpo, el hogar de la vida,
El cuerpo, el hogar de la vida,
Es el cuerpo, el hogar de la vida.

La copa de oro, llena de vida,
Es el cuerpo, el hogar de la vida,
El cuerpo, el hogar de la vida,
Es el cuerpo, el hogar de la vida.

La copa de oro, llena de vida,
Es el cuerpo, el hogar de la vida,
El cuerpo, el hogar de la vida,
Es el cuerpo, el hogar de la vida.

La copa de oro, llena de vida,
Es el cuerpo, el hogar de la vida,
El cuerpo, el hogar de la vida,
Es el cuerpo, el hogar de la vida.

La copa de oro, llena de vida,
Es el cuerpo, el hogar de la vida,
El cuerpo, el hogar de la vida,
Es el cuerpo, el hogar de la vida.

La copa de oro, llena de vida,
Es el cuerpo, el hogar de la vida,
El cuerpo, el hogar de la vida,
Es el cuerpo, el hogar de la vida.

La copa de oro, llena de vida,
Es el cuerpo, el hogar de la vida,
El cuerpo, el hogar de la vida,
Es el cuerpo, el hogar de la vida.

La copa de oro, llena de vida,
Es el cuerpo, el hogar de la vida,
El cuerpo, el hogar de la vida,
Es el cuerpo, el hogar de la vida.

La copa de oro, llena de vida,
Es el cuerpo, el hogar de la vida,
El cuerpo, el hogar de la vida,
Es el cuerpo, el hogar de la vida.

La copa de oro, llena de vida,
Es el cuerpo, el hogar de la vida,
El cuerpo, el hogar de la vida,
Es el cuerpo, el hogar de la vida.

La copa de oro, llena de vida,
Es el cuerpo, el hogar de la vida,
El cuerpo, el hogar de la vida,
Es el cuerpo, el hogar de la vida.

La copa de oro, llena de vida,
Es el cuerpo, el hogar de la vida,
El cuerpo, el hogar de la vida,
Es el cuerpo, el hogar de la vida.

La copa de oro, llena de vida,
Es el cuerpo, el hogar de la vida,
El cuerpo, el hogar de la vida,
Es el cuerpo, el hogar de la vida.

La copa de oro, llena de vida,
Es el cuerpo, el hogar de la vida,
El cuerpo, el hogar de la vida,
Es el cuerpo, el hogar de la vida.

La copa de oro, llena de vida,
Es el cuerpo, el hogar de la vida,
El cuerpo, el hogar de la vida,
Es el cuerpo, el hogar de la vida.

La copa de oro, llena de vida,
Es el cuerpo, el hogar de la vida,
El cuerpo, el hogar de la vida,
Es el cuerpo, el hogar de la vida.

La copa de oro, llena de vida,
Es el cuerpo, el hogar de la vida,
El cuerpo, el hogar de la vida,
Es el cuerpo, el hogar de la vida.

La copa de oro, llena de vida,
Es el cuerpo, el hogar de la vida,
El cuerpo, el hogar de la vida,
Es el cuerpo, el hogar de la vida.

La copa de oro, llena de vida,
Es el cuerpo, el hogar de la vida,
El cuerpo",es,0,2237,0,2237,0.0,[],[]
22,"El Paje de Bastos en el contexto del Agua representa la capacidad de conectar con las profundidades emocionales y la sabiduría intuitiva. Este personaje es un explorador, un buscador de sabiduría, y su presencia en esta carta sugiere que el buscador está en un proceso de descubrimiento y aprendizaje a través de sus emociones. El Paje de Bastos en el Agua es un llamado a la introspección y la conexión con los sentimientos más profundos, ofreciendo una oportunidad para entender y explorar las emociones que guían la vida.",es,0,88,0,88,0.0,[],[]
23,"La fuerza es el elemento que nos impulsa hacia adelante, a pesar de las dificultades y las adversidades. Es la energía que nos permite superar las barreras y alcanzar nuestros objetivos. La fuerza es el impulso vital que nos mantiene en movimiento, a pesar de las dificultades y las adversidades. Es el poder que nos permite superar las barreras y alcanzar nuestros objetivos. La fuerza es el elemento que nos impulsa hacia adelante, a pesar de las dificultades y las adversidades. Es el poder que nos permite superar las barreras y alcanzar nuestros objetivos. La fuerza es el elemento que nos impulsa hacia adelante, a pesar de las dificultades y las adversidades. Es el poder que nos permite superar las barreras y alcanzar nuestros objetivos. La fuerza es el elemento que nos impulsa hacia adelante, a pesar de las dificultades y las adversidades. Es el poder que nos permite superar las barreras y alcanzar nuestros objetivos. La fuerza es el elemento que nos impulsa hacia adelante, a pesar de las dificultades y las adversidades. Es el poder que nos permite superar las barreras y alcanzar nuestros objetivos. La fuerza es el elemento que nos impulsa hacia adelante, a pesar de las dificultades y las adversidades. Es el poder que nos permite superar las barreras y alcanzar nuestros objetivos. La fuerza es el elemento que nos impulsa hacia adelante, a pesar de las dificultades y las adversidades. Es el poder que nos permite superar las barreras y alcanzar nuestros objetivos. La fuerza es el elemento que nos impulsa hacia adelante, a pesar de las dificultades y las adversidades. Es el poder que nos permite superar las barreras y alcanzar nuestros objetivos. La fuerza es el elemento que nos impulsa hacia adelante, a pesar de las dificultades y las adversidades. Es el poder que nos permite superar las barreras y alcanzar nuestros objetivos. La fuerza es el elemento que nos impulsa hacia adelante, a pesar de las dificultades y las adversidades. Es el poder que nos permite superar las barreras y alcanzar nuestros objetivos. La fuerza es el elemento que nos impulsa hacia adelante, a pesar de las dificultades y las adversidades. Es el poder que nos permite superar las barreras y alcanzar nuestros objetivos. La fuerza es el elemento que nos impulsa hacia adelante, a pesar de las dificultades y las adversidades. Es el poder que nos permite superar las barreras y alcanzar nuestros objetivos. La fuerza es el elemento que nos impulsa hacia adelante, a pesar de las dificultades y las adversidades. Es el poder que nos permite superar las barreras y alcanzar nuestros objetivos. La fuerza es el elemento que nos impulsa hacia adelante, a pesar de las dificultades y las adversidades. Es el poder que nos permite superar las barreras y alcanzar nuestros objetivos. La fuerza es el elemento que nos impulsa hacia adelante, a pesar de las dificultades y las adversidades. Es el poder que nos permite superar las barreras y alcanzar nuestros objetivos. La fuerza es el elemento que nos impulsa hacia adelante, a pesar de las dificultades y las adversidades. Es el poder que nos permite superar las barreras y alcanzar nuestros objetivos. La fuerza es el elemento que nos impulsa hacia adelante, a pesar de las dificultades y las adversidades. Es el poder que nos permite superar las barreras y alcanzar nuestros objetivos. La fuerza es el elemento que nos impulsa hacia adelante, a pesar de las dificultades y las adversidades. Es el poder que nos permite superar las barreras y alcanzar nuestros objetivos. La fuerza es el elemento que nos impulsa hacia adelante, a pesar de las dificultades y las adversidades. Es el poder que nos permite superar las barreras y alcanzar nuestros objetivos. La fuerza es el elemento que nos impulsa hacia adelante, a pesar de las dificultades y las adversidades. Es el poder que nos permite superar las barreras y alcanzar nuestros objetivos. La fuerza es el elemento que nos impulsa hacia adelante, a pesar de las dificultades y las adversidades. Es el poder que nos permite superar las barreras y alcanzar nuestros objetivos. La fuerza es el elemento que nos impulsa hacia adelante, a pesar de las dificultades y las adversidades. Es el poder que nos permite superar las barreras y alcanzar nuestros objetivos. La fuerza es el elemento que nos impulsa hacia adelante, a pesar de las dificultades y las adversidades. Es el poder que nos permite superar las barreras y alcanzar nuestros objetivos. La fuerza es el elemento que nos impulsa hacia adelante, a pesar de las dificultades y las adversidades. Es el poder que nos permite superar las barreras y alcanzar nuestros objetivos. La fuerza es el elemento que nos impulsa hacia adelante, a pesar de las dificultades y las adversidades. Es el poder que nos permite superar las barreras y alcanzar nuestros objetivos. La fuerza es el elemento que nos impulsa hacia adelante, a pesar de las dificultades y las adversidades. Es el poder que nos permite superar las barreras y alcanzar nuestros objetivos. La fuerza es el elemento que nos impulsa hacia adelante, a pesar de las dificultades y las adversidades. Es el poder que nos permite superar las barreras y alcanzar nuestros objetivos. La fuerza es el elemento que nos impulsa hacia adelante, a pesar de las dificultades y las adversidades. Es el poder que nos permite superar las barreras y alcanzar nuestros objetivos. La fuerza es el elemento que nos impulsa hacia adelante, a pesar de las dificultades y las adversidades. Es el poder que nos permite superar las barreras y alcanzar nuestros objetivos. La fuerza es el elemento que nos impulsa hacia adelante, a pesar de las dificultades y las adversidades. Es el poder que nos permite superar las barreras y alcanzar nuestros objetivos. La fuerza es el elemento que nos impulsa hacia adelante, a pesar de las dificultades y las adversidades. Es el poder que nos permite superar las barreras y alcanzar nuestros objetivos. La fuerza es el elemento que nos impulsa hacia adelante, a pesar de las dificultades y las adversidades. Es el poder que nos permite superar las barreras y alcanzar nuestros objetivos. La fuerza es el elemento que nos impulsa hacia adelante, a pesar de las dificultades y las adversidades. Es el poder que nos permite superar las barreras y alcanzar nuestros objetivos. La fuerza es el elemento que nos impulsa hacia adelante, a pesar de las dificultades y las adversidades. Es el poder que nos permite superar las barreras y alcanzar nuestros objetivos. La fuerza es el elemento que nos impulsa hacia adelante, a pesar de las dificultades y las adversidades. Es el poder que nos permite superar las barreras y alcanzar nuestros objetivos. La fuerza es el elemento que nos impulsa hacia adelante, a pesar de las dificultades y las adversidades. Es el poder que nos permite superar las barreras y alcanzar nuestros objetivos. La fuerza es el elemento que nos impulsa hacia adelante, a pesar de las dificultades y las adversidades. Es el poder que nos permite superar las barreras y alcanzar nuestros objetivos. La fuerza es el elemento que nos impulsa hacia adelante, a pesar de las dificultades y las adversidades. Es el poder que nos permite superar las barreras y alcanzar nuestros objetivos. La fuerza es el elemento que nos impulsa hacia adelante, a pesar de las dificultades y las adversidades. Es el poder que nos permite superar las barreras y alcanzar nuestros objetivos. La fuerza es el elemento que nos impulsa hacia adelante, a pesar de las dificultades y las adversidades. Es el poder que nos permite superar las barreras y alcanzar nuestros objetivos. La fuerza es el elemento que nos impulsa hacia adelante, a pesar de las dificultades y las adversidades. Es el poder que nos permite superar las barreras y alcanzar nuestros objetivos. La fuerza es el elemento que nos impulsa hacia adelante, a pesar de las dificultades y las adversidades. Es el poder que nos permite superar las barreras y alcanzar nuestros objetivos. La fuerza es el elemento que nos impulsa hacia adelante, a pesar de las dificultades y las adversidades. Es el poder que nos permite superar las barreras y alcanzar nuestros objetivos. La fuerza es el elemento que nos impulsa hacia adelante, a pesar de las dificultades y las adversidades. Es el poder que nos permite superar las barreras y alcanzar nuestros objetivos. La fuerza es el elemento que nos impulsa hacia adelante, a pesar de las dificultades y las adversidades. Es el poder que nos permite superar las barreras y alcanzar nuestros objetivos. La fuerza es el elemento que nos impulsa hacia adelante, a pesar de las dificultades y las adversidades. Es el poder que nos permite superar las barreras y alcanzar nuestros objetivos. La fuerza es el elemento que nos impulsa hacia adelante, a pesar de las dificultades y las adversidades. Es el poder que nos permite superar las barreras y alcanzar nuestros objetivos. La fuerza es el elemento que nos impulsa hacia adelante, a pesar de las dificultades y las adversidades. Es el poder que nos permite superar las barreras y alcanzar nuestros objetivos. La fuerza es el elemento que nos impulsa hacia adelante, a pesar de las dificultades y las adversidades. Es el poder que nos permite superar las barreras y alcanzar nuestros objetivos. La fuerza es el elemento que nos impulsa hacia adelante, a pesar de las dificultades y las adversidades. Es el poder que nos permite superar las barreras y alcanzar nuestros objetivos. La fuerza es el elemento que nos impulsa hacia adelante, a pesar de las dificultades y las adversidades. Es el poder que nos permite superar las barreras y alcanzar nuestros objetivos. La fuerza es el elemento que nos impulsa hacia adelante, a pesar de las dificultades y las adversidades. Es el poder que nos permite superar las barreras y alcanzar nuestros objetivos. La fuerza es el elemento que nos impulsa hacia adelante, a pesar de las dificultades y las adversidades. Es el poder que nos permite superar las barreras y alcanzar nuestros objetivos. La fuerza es el elemento que nos impulsa hacia adelante, a pesar de las dificultades y las adversidades. Es el poder que nos permite superar las barreras y alcanzar nuestros objetivos. La fuerza es el elemento que nos impulsa hacia adelante, a pesar de las dificultades y las adversidades. Es el poder que nos permite superar las barreras y alcanzar nuestros objetivos. La fuerza es el elemento que nos impulsa hacia adelante, a pesar de las dificultades y las adversidades. Es el poder que nos permite superar las barreras y alcanzar nuestros objetivos. La fuerza es el elemento que nos impulsa hacia adelante, a pesar de las dificultades y las adversidades. Es el poder que nos permite superar las barreras y alcanzar nuestros objetivos. La fuerza es el elemento que nos impulsa hacia adelante, a pesar de las dificultades y las adversidades. Es el poder que nos permite superar las barreras y alcanzar nuestros objetivos. La fuerza es el elemento que nos impulsa hacia adelante, a pesar de las dificultades y las adversidades. Es el poder que nos permite superar las barreras y alcanzar nuestros objetivos. La fuerza es el elemento que nos impulsa hacia adelante, a pesar de las dificultades y las adversidades. Es el poder que nos permite superar las barreras y alcanzar nuestros objetivos. La fuerza es el elemento que nos impulsa hacia adelante, a pesar de las dificultades y las adversidades. Es el poder que nos permite superar las barreras y alcanzar nuestros objetivos. La fuerza es el elemento que nos impulsa hacia adelante, a pesar de las dificultades y las adversidades. Es el poder que nos permite superar las barreras y alcanzar nuestros objetivos. La fuerza es el elemento que nos impulsa hacia adelante, a pesar de las dificultades y las adversidades. Es el poder que nos permite superar las barreras y alcanzar nuestros objetivos. La fuerza es el elemento que nos impulsa hacia adelante, a pesar de las dificultades y las adversidades. Es el poder que nos permite superar las barreras y alcanzar nuestros objetivos. La fuerza es el elemento que nos impulsa hacia adelante, a pesar de las dificultades y las adversidades. Es el poder que nos permite superar las barreras y alcanzar nuestros objetivos. La fuerza es el elemento que nos impulsa hacia adelante, a pesar de las dificultades y las adversidades. Es el poder que nos permite superar las barreras y alcanzar nuestros objetivos. La fuerza es el elemento que nos impulsa hacia adelante, a pesar de las dificultades y las adversidades. Es el poder que nos permite superar las barreras y alcanzar nuestros objetivos. La fuerza es el elemento que nos impulsa hacia adelante, a pesar de las dificultades y las adversidades. Es el poder que nos permite superar las barreras y alcanzar nuestros objetivos. La fuerza es el elemento que nos impulsa hacia adelante, a pesar de las dificultades y las adversidades. Es el poder que nos permite superar las barreras y alcanzar nuestros objetivos. La fuerza es el elemento que nos impulsa hacia adelante, a pesar de las dificultades y las adversidades. Es el poder que nos permite superar las barreras y alcanzar nuestros objetivos. La fuerza es el elemento que nos impulsa hacia adelante, a pesar de las dificultades y las adversidades. Es el poder que nos permite superar las barreras y alcanzar nuestros objetivos. La fuerza es el elemento que nos impulsa hacia adelante, a pesar de las dificultades y las adversidades. Es el poder que nos permite superar las barreras y alcanzar nuestros objetivos. La fuerza es el elemento que nos impulsa hacia adelante, a pesar de las dificultades y las adversidades. Es el poder que nos permite superar las barreras y alcanzar nuestros objetivos. La fuerza es el elemento que nos impulsa hacia adelante, a pesar de las dificultades y las adversidades. Es el poder que nos permite superar las barreras y alcanzar nuestros objetivos. La fuerza es el elemento que nos impulsa hacia adelante, a pesar de las dificultades y las adversidades. Es el poder que nos permite superar las barreras y alcanzar nuestros objetivos. La fuerza es el elemento que nos impulsa hacia adelante, a pesar de las dificultades y las adversidades. Es el poder que nos permite superar las barreras y alcanzar nuestros objetivos. La fuerza es el elemento que nos impulsa hacia adelante, a pesar de las dificultades y las adversidades. Es el poder que nos permite superar las barreras y alcanzar nuestros objetivos. La fuerza es el elemento que nos impulsa hacia adelante, a pesar de las dificultades y las adversidades. Es el poder que nos permite superar las barreras y alcanzar nuestros objetivos. La fuerza es el elemento que nos impulsa hacia adelante, a pesar de las dificultades y las adversidades. Es el poder que nos permite superar las barreras y alcanzar nuestros objetivos. La fuerza es el elemento que nos impulsa hacia adelante, a pesar de las dificultades y las adversidades. Es el poder que nos permite superar las barreras y alcanzar nuestros objetivos. La fuerza es el elemento que nos impulsa hacia adelante, a pesar de las dific",es,0,2526,1,2527,0.0,[],['dific']
