Fila,Prompt,Idioma original,en,es,unknown,total,contamination,words,unknown_words
0,"The water card offers a glimpse into the depths of the emotional realm. Our feelings run like a river through the landscape of the psyche, shaping our inner world and influencing our interactions with the outer world. The water card encourages us to explore the currents of our emotions, to dive beneath the surface and confront the hidden depths. It is here, in the stillness of the subconscious, that we discover the seeds of self-knowledge. Water symbolizes the transformative power of emotional release and healing. By embracing the flow of feelings, we release the burdens of the past and open ourselves to new possibilities. The water card reminds us that our emotions, though at times overwhelming, are a vital source of wisdom and insight. They guide us through the uncharted waters of the soul, leading us to self-actualization and wholeness.",en,127,15,0,142,0.106,"['a', 'run', 'a', 'to', 'explore', 'to', 'here', 'open', 'to', 'times', 'are', 'a', 'vital', 'soul', 'to']",[]
1,"The Air card whispers of the delicate dance between thought and communication, the lifeblood of the mind. It speaks of the countless breaths that we take each day, inhaling the vastness of existence and exhaling our unique perspective back into the world. In the realm of the intellect, the Air card represents the swirling winds of ideas, the ebbs and flows of inspiration and analysis. It nudges us to examine the words that fall from our lips - are they crystal clear or muffled by habit and conditioning? Does our inner dialogue nourish or poison our psyche? The card invites us to step onto the path of clarity, to speak and listen with intention. For it is through this sacred exchange, this breath of creation and destruction, that we give birth to new thoughts and experiences. The Air card is a reminder to cherish each interaction, to approach both speaking and listening as sacred acts. For in the end, it is not the destination that matters, but the quality of the journey - the luminous trails of meaning that we weave with every word and every breath.",en,169,16,0,185,0.086,"['dance', 'ideas', 'to', 'examine', 'are', 'dialogue', 'invites', 'to', 'onto', 'to', 'listen', 'to', 'a', 'to', 'to', 'as']",[]
2,"The Turning of the Wands: 
Your message has been received.
Your question has been heard.
Your curiosity has been sparked, 
And your quest has been imbued with new light.

In the realm of the Wands, three cards stand sentinel - 
A torch to pierce the veils of the unknown,
A flame to illuminate the winding path ahead,
And a scepter to guide you, a true leader.

The Wands hold the power of creation and action,
To shape reality through will and vision.
They are the tools we wield to manifest our dreams,
The implements we use to make the intangible tangible.

In your hand, the Three of Wands stands proud - 
A card of beginnings, of seeds taking root.
The power of creation flows through your veins,
The potential within you, ready to burst and fruit.

The Wands have turned, and your journey is at hand,
The journey to discover, to explore, to grow.
May the light of the Wands be your guide,
As you venture forth, your own story to unfold.",en,137,32,1,170,0.188,"['has', 'has', 'has', 'has', 'light', 'stand', 'a', 'to', 'a', 'to', 'a', 'to', 'a', 'true', 'to', 'reality', 'are', 'to', 'use', 'to', 'intangible', 'tangible', 'a', 'to', 'to', 'to', 'explore', 'to', 'light', 'be', 'as', 'to']",['proud']
3,"The Ten of Pentacles, the earthly aspect of the Self-Knowledge Star Spread, invites reflection on the tangible realm of physical manifestation and material resources. The element of earth represents stability, structure, and the body - how our inner vitality is channeled into the outer world. It asks: What is the state of my physical health and well-being? How do I relate to and utilize the resources available to me, be it money, food, shelter or the natural world? What lies dormant within, waiting to be expressed? This card suggests the need to connect with our earthiness, our groundedness, and to manifest our intentions through concrete actions and tangible results. It prompts us to approach the material plane with intention and care, recognizing the sacredness of all things.",en,105,23,0,128,0.18,"['ten', 'invites', 'tangible', 'material', 'body', 'do', 'i', 'relate', 'to', 'to', 'me', 'be', 'natural', 'to', 'be', 'to', 'to', 'concrete', 'tangible', 'to', 'material', 'plane', 'care']",[]
4,"The card of the Queen of Swords holds the paradox of material stability within fluid change.  The sword cuts through illusion to reveal raw truth while the crown signifies kingly authority. Her posture is poised between the intellect and the emotions - the dual aspects of the psyche in balance. The mirrored pattern in her design suggests the reflective inner world, where thoughts and feelings dance beneath the surface of the mind. Her gaze looks inward, implying a reflective, introspective state. The image of the Queen of Swords reminds us that true wisdom grows from the depths - the wellspring of insight is within. She stands steady amidst the turmoil, her poise and strength a testament to the power of inner calm in the face of uncertainty. This card invites us to look beneath our reactions and find the source of our truth. It points to the importance of mental clarity, self-knowledge, and the ability to cut through mental noise and illusion to discern our authentic nature. The path of the Queen of Swords leads to self-reliance and steadfastness in the midst of change.",en,156,28,0,184,0.152,"['queen', 'material', 'fluid', 'to', 'her', 'dual', 'balance', 'her', 'dance', 'her', 'a', 'queen', 'true', 'her', 'poise', 'a', 'to', 'invites', 'to', 'look', 'to', 'mental', 'to', 'mental', 'to', 'nature', 'queen', 'to']",[]
5,"The Queen of Pentacles sits upon her throne of flowers and abundance, her robes flowing with vibrant petals that dance in the breeze. She is the embodiment of the element of water, a symbol of the deep, uncharted realms of the psyche. This tarot card is a reminder to dive beneath the surface of our awareness, to immerse ourselves in the currents of our own feelings and subconscious depths. It invites us to connect with the vast ocean of emotion that resides within, to explore the waters that shape our inner landscape. The Queen's presence is both calming and challenging, a gentle nudge to embrace the full spectrum of our emotional experiences, the joys and sorrows, the ecstasy and the pain. She encourages us to flow with the tides of our feelings, to ride the waves of our hearts with grace and compassion. In this sacred space of introspection, we may discover hidden treasures, long-buried passions, and the seeds of transformation. The Queen of Pentacles is a guide to help us navigate the unpredictable waters, to dive deep and surface renewed, tempered and enlightened by the journey.",en,162,27,0,189,0.143,"['queen', 'her', 'her', 'robes', 'dance', 'a', 'tarot', 'a', 'to', 'to', 'invites', 'to', 'resides', 'to', 'explore', 'queen', 'a', 'to', 'embrace', 'full', 'to', 'to', 'buried', 'queen', 'a', 'to', 'to']",[]
6,"Fire Card in the Tarot of the Kabbalistic Tree of Life 
The Fire card bursts forth, a radiant orb of passion and will,
Illuming the realms of the psyche, a burning desire fulfilled.
Its flames dance with the drive of Prometheus's torch,
Stealing the sacred spark to ignite a higher purpose fulfilled.
One cannot possess Fire, but rather, it possesses the self.
The Kabbalistic Tree of Life stands tall, a metaphor for growth,
As the questing seeker, guided by the serpent's wise counsel to ascend.
The Fire that flows through all things, a divine current of consciousness, 
Becomes the key to self-realization, one's sacred mission, and the path of the Wise.
The initiate must claim Fire's mantle for themselves,
To become the will, the doer, the active force in the universe.
Only then, will the inner power of all creation be unleashed,
And the seeker's true nature be revealed and made manifest.
The journey of the hero, the path to actualization, 
Is fueled by the eternal flame of the Fire card's sacred fire.",en,154,22,4,180,0.122,"['tarot', 'a', 'a', 'dance', 'to', 'a', 'a', 'as', 'to', 'a', 'divine', 'to', 'to', 'active', 'be', 'true', 'nature', 'be', 'hero', 'to', 'fueled', 'eternal']","['kabbalistic', 'fulfilled', 'fulfilled', 'kabbalistic']"
7,"The turning of the Four of Cups invites us to contemplate the interplay between the spiritual and material realms. This earth card symbolizes the grounding force that connects us to the physical world and our own bodies. At this stage, questions arise about how we manifest our highest intentions in the tangible sphere. The Four of Cups reminds us that our inner vision can only be made manifest through consistent, hands-on effort. It's time to translate our dreams and aspirations into concrete actions, to take bold steps towards bringing our goals to life. The path forward requires us to engage with the world of form - to plant the seeds of our desires in the fertile soil of reality. This card is a call to action, to bring the divine into the domain of the senses and experience the power of our own creation. The message is clear: our personal destiny and the fulfillment of our highest purpose can only unfold through active participation in the dance of life, as we embody and express our truth in the arena of form.",en,156,26,0,182,0.143,"['invites', 'to', 'material', 'to', 'bodies', 'tangible', 'can', 'be', 'time', 'to', 'concrete', 'to', 'to', 'to', 'to', 'reality', 'a', 'to', 'to', 'divine', 'personal', 'can', 'active', 'dance', 'as', 'arena']",[]
8,"The Ten of Swords sits upon the bed of cards, its fiery blade poised to cut through the veil of the mundane world. The element of Fire courses through its veins, an unquenchable passion that drives the sword forward with resolute determination. In the realm of divine will, the Fire card is the radiant core around which the cycles of creation and destruction revolve. It is the impetuous force that shatters stagnation and sets the wheels of change in motion. The Ten of Swords demands that you look within yourself - to that sacred space where your deepest desires and purpose reside. There, in the stillness of your inner world, you will discover the spark of the divine that lies dormant, waiting to be awakened. This is the wellspring of your true power, the source of your untapped potential. The path ahead is not an easy one - it will require courage to confront the shadows and unleash the fire that burns within. But in doing so, you will emerge transformed, your will tempered in the crucible of your inner strength. The Fire card beckons you to embrace your passions, to let them ignite your spirit and drive you forward on your journey of self-discovery and growth.",en,186,20,0,206,0.097,"['ten', 'to', 'divine', 'core', 'revolve', 'sets', 'ten', 'look', 'to', 'reside', 'divine', 'to', 'be', 'true', 'to', 'so', 'emerge', 'to', 'embrace', 'to']",[]
9,"The clouds part, revealing a vast expanse of sky above. The sun, a golden orb of radiant light, illuminates the earth below - a tapestry woven from the threads of our hopes, dreams, and aspirations. In this moment, we find ourselves suspended in an eternal dance, our spirits yearning to merge with the divine essence that flows through all things. The trees sway in the gentle breeze, whispering ancient secrets of what lies beyond the veil of our limited perception. A single cloud drifts by, a fleeting reminder of the ever-changing nature of our reality. In this ephemeral dance, we are both the dancers and the choreography of our lives, forever seeking to align our inner world with the external realm. 

This reading aims to evoke a sense of connection, balance, and harmony between the spiritual and material aspects of existence. The focus on the Earth element encourages the querent to consider how their inner world and outer reality intersect. It suggests that personal growth and fulfillment come from a harmonious relationship between our deepest aspirations and practical actions. The poetic language invites reflection on the relationship between the spiritual and physical realms, and how we can align our innermost desires with our daily lives. The vivid imagery of clouds, sun,",en,181,30,0,211,0.142,"['a', 'a', 'light', 'a', 'hopes', 'suspended', 'eternal', 'dance', 'to', 'divine', 'a', 'single', 'a', 'nature', 'reality', 'dance', 'are', 'to', 'to', 'a', 'balance', 'material', 'to', 'reality', 'personal', 'come', 'a', 'invites', 'can', 'vivid']",[]
10,"Moonlight danced upon the tranquil lake, a shimmering ballet of shadow and illumination. The water's surface, once still as glass, now swirled with eddies of emotion, each one a tale waiting to be told. Beneath the moon's ethereal glow, secrets long buried began to surface, rising from the depths of the subconscious like bubbles from a sleeping sea. The Page of Wands materialized from the water's womb, a conduit between worlds, between the conscious and unconscious mind. With one hand, the Page held a lantern, a beacon to guide the seeker through uncharted waters of the psyche. The other hand, extended, yearned to connect, to find solid ground in the swirling tides of feeling. The lantern's light, a golden splash amidst the darkness, illuminated a path to self-knowledge. It whispered of the power within, the spark of intuition that burns constant within the soul. The water, a mirror of the mind, reflected the seeker's essence back - a kaleidoscope of memories, dreams, and hidden longings. Amidst the chaos of thoughts and emotions, the Page offered a tranquil center, a place to pause and ponder. For in the stillness, the seeker may find",en,161,36,0,197,0.183,"['tranquil', 'a', 'ballet', 'once', 'as', 'a', 'tale', 'to', 'be', 'buried', 'to', 'a', 'sea', 'a', 'a', 'a', 'to', 'extended', 'to', 'to', 'solid', 'light', 'a', 'a', 'to', 'soul', 'a', 'a', 'chaos', 'a', 'tranquil', 'center', 'a', 'place', 'to', 'pause']",[]
11,"The Star, Knight, and World cards are in position to reveal a message about the querent's spiritual journey and the path forward. The Star's celestial guidance suggests that the querent is at a crossroads, with the potential for great illumination and purpose ahead, but also the possibility of confusion and inner turmoil. The Knight's arrival indicates a need for action and initiative, to move forward and claim one's power and destiny. The World card's appearance signals a renaissance and the integration of different aspects of the querent's being. The querent must learn to trust their intuition and inner wisdom, for it will guide them through the challenges ahead. The road may be uncertain, but with courage and determination, the querent can navigate the changes and emerge with a greater understanding of themselves and their place in the grand design.",en,129,16,0,145,0.11,"['are', 'to', 'a', 'celestial', 'a', 'a', 'to', 'a', 'to', 'trust', 'be', 'can', 'emerge', 'a', 'place', 'grand']",[]
12,"El agua, que fluye a través de la tierra, reflejando la luz del cielo arqueado. Se escucha el sonido del arroyuelo, constantemente cambando mío modo, como el ritmo de un corazón. El agua no juge, no critica. Simplemente fluye, acariciando cada rincón hasta llegar a la fuente de abajo. Y ahí, en lo más profundo, está la clave. El punto donde la conciencia se hunde en los sentimientos más antiguos y primitivos. El punto en el que la emoción se conoce a sí misma.",es,0,82,2,84,0.0,[],"['arroyuelo', 'juge']"
13,"El tarot de Aire te invita a reflexionar sobre la comunicación y el pensamiento. La carta de Aire te muestra que el elemento aire es fundamental para la mente y la inteligencia. Es el aliento vital que conecta a los seres con los universos más elevados, permitiendo la transmisión de ideas y la interacción social. Cada respiración es una oportunidad para conectarse con la sabiduría superior. Ahora, es hora de escuchar a tu interior y exterior. Explora cómo tus pensamientos y palabras moldean tu realidad personal y tu comprensión del mundo. La claridad en la comunicación interna te guiará hacia un entendimiento más profundo de ti mismo y de tu entorno. Confía en la sabiduría divina que está siempre dentro de ti, esperando que tomes el primer paso en tu camino hacia la iluminación.",es,0,133,1,134,0.0,[],['conectarse']
14,"The Three of Cups reversed
Upon seeing this card, I am drawn into a reverie of the ephemeral nature of life. The Three of Cups, inverted, speaks to the fleeting, momentary quality of human connection and the inevitability of change. Just as the cups have been overturned, so too are our relationships and experiences transitory. The image of three empty vessels evokes a sense of the ephemeral, the intangible, the unattainable. And yet, in the reversal, there is a glimmer of hope - a reminder that the contents of a cup are not lost, but merely dispersed, waiting to be poured out anew. This card whispers of the impermanence of all things and the need to cherish each moment, for it is a rare opportunity to experience the raw beauty of the present.",es,110,22,0,132,0.833,"['the', 'three', 'of', 'cups', 'reversed', 'upon', 'seeing', 'this', 'card', 'drawn', 'into', 'reverie', 'of', 'the', 'ephemeral', 'of', 'life', 'the', 'three', 'of', 'cups', 'inverted', 'speaks', 'the', 'fleeting', 'momentary', 'quality', 'of', 'connection', 'and', 'the', 'inevitability', 'of', 'change', 'just', 'the', 'cups', 'have', 'been', 'overturned', 'our', 'relationships', 'and', 'experiences', 'transitory', 'the', 'image', 'of', 'three', 'empty', 'vessels', 'evokes', 'sense', 'of', 'the', 'ephemeral', 'the', 'the', 'unattainable', 'and', 'yet', 'in', 'the', 'reversal', 'there', 'is', 'glimmer', 'of', 'reminder', 'that', 'the', 'contents', 'of', 'cup', 'not', 'lost', 'but', 'merely', 'dispersed', 'waiting', 'poured', 'out', 'anew', 'this', 'card', 'whispers', 'of', 'the', 'impermanence', 'of', 'all', 'things', 'and', 'the', 'need', 'cherish', 'each', 'moment', 'for', 'it', 'is', 'rare', 'opportunity', 'experience', 'the', 'raw', 'beauty', 'of', 'the', 'present']",[]
15,"<response>
El diez de Oros, la carta de Tierra, invita a reflexionar sobre los recursos y la manifestación física. Esta carta es un llamado a la acción, para examinar cómo estos elementos influyen en nuestras vidas. Puede ser que esté perdiendo el equilibrio entre mi aspiración espiritual y las prácticas diarias. Tal vez haya resistido a la establecer conexión con la materia, o a permitir que este elemento controle mis acciones. El mensaje es de equilibrar, de encontrar una conexión saludable entre lo intangible y lo tangible. Solo mediante esta alineación entre la mente y el cuerpo, podemos manifestar nuestros más altos deseos en el mundo. Una nueva forma de gestión es necesaria. El dinero, la salud, el medio ambiente, ellos son los recursos más importantes en estas cartas. Su relación con ellos debe ser vista de una manera equilibrada, que refleje su verdadero ser. No se debe perseguir el material por su propio fin, sino como un medio para alcanzar la realización interior y conectarse con algo más amplio. El elemento de la Ti",es,0,174,1,175,0.0,[],['conectarse']
16,"La reina de Espadas, terciopelo y cuchilla en la mano derecha, apunta hacia abajo mientras una estrella resplandeciente se desliza por su diestra y baja en el escote izquierdo. Ella está sentada sobre un asiento de terciopelo, vestida con un traje de seda de color naranja que se cierra sobre un vestido de luster en la ropa interior. El escote del vestido cuelga en la cintura, mientras que el escote del sostén se cierra sobre la clavícula. Su pecho se revela a través de la delgada tela sedosa, y el escote se revela debajo de la ropa interior. Un guante de seda de color naranja cubre la mano derecha.

Araña el signo zodiac del león todo el tiempo. Un escote de seda de color naranja se desliza hacia abajo desde la tienda y se cierra en el escote izquierdo de un traje de terciopelo. Un escote de seda de color rojo",es,2,149,0,151,0.013,"['luster', 'zodiac']",[]
17,"El Tarot como espejo de la profunda piscis de las florecidas emociiones y sentimientos más íntimos, el agua simboliza el flujo interno hacia abajo y en el fondo de los seres humanos. En este elemento misterioso, debemos sumergirnos para comprender mejor nuestras verdaderas emociones y sentimientos más allá de las manifestaciones superficiales. El agua nos invita a explorar las profundidades de nuestro yo más esencial y la sabiduría intuitiva que surge de ella. Alzando el paravasaje de la empatia, el agua nos conecta con los demás, permitiendo una comprension más profunda de las experiencias comunes y los sentimientos compartidos. Esta carta de agua llena el vacio interior, llamando a la introspeccion para identificar las emociones dominantes y su impacto en el dia a dia. Al evaluar como estas fuerzas influyen en la toma de decisiones y en las interacciones con otros, el agua nos anima a honrar la sensible emocional como herramienta de la conexión y el autodescub",es,0,146,12,158,0.0,[],"['emociiones', 'íntimos', 'sumergirnos', 'paravasaje', 'empatia', 'comprension', 'vacio', 'introspeccion', 'dominantes', 'dia', 'dia', 'autodescub']"
18,"El fuego arde dentro de ti, impulso y voluntad, ardiente con la pasión de la creación. El fuego es el motor del cambio, la chispa divina que enciende el deseo y la determinación. Mira cómo su energía se manifiesta en tus acciones y decisiones. Los Fuego que consumes y transforma, tanto destruye como construye, para dar lugar a nuevas creaciones. Ahora reflexiona sobre lo que te motiva y qué propósito es el que guía tus pasos. El Fuego te invita a reconocer y canalizar adecuadamente tu poder interior. Tú tienes el fuego dentro, la fuerza divina para transformar tu realidad. Márcate, aprisiona y libera tus deseos auténticos, alineándolos con un propósito mayor. Solo así puedes encender tu fuego y convertirlo en una llama que ilumina tu camino.",es,0,123,4,127,0.0,[],"['adecuadamente', 'márcate', 'alineándolos', 'convertirlo']"
19,"The four of cups, reversed, indicates a significant shift in perspective. This card's message echoes the themes of grounding, stability and manifestation.

In the physical realm, the earth represents the solid foundation upon which our tangible experiences take root. It underscores the importance of anchoring our emotional and spiritual aspirations in concrete, everyday actions. The earth is not just a passive backdrop, but an active force—sustaining life, nurturing growth, providing sustenance. 

Through the lens of the Tarot, the four of cups suggests a re-evaluation of our relationship with material resources and physical well-being. It prompts us to consider how we are using our tools, talents and environment to their fullest potential. Are our daily practices and habits aligning with our deepest values? Are we cultivating a balanced, harmonious relationship between our inner and outer worlds?

At the heart of this card's symbolism lies the concept of manifestation. The earth teaches us that our thoughts, dreams and intentions can be turned into tangible reality. It reminds us to take action, to put our plans into motion. The fertile soil of our minds and hearts must be tilled with purpose and nourished with consistent effort.

Ultimately, the four of cups inverts the notion of what constitutes success",es,185,25,0,210,0.881,"['the', 'four', 'of', 'cups', 'reversed', 'indicates', 'significant', 'shift', 'in', 'perspective', 'this', 'card', 's', 'message', 'the', 'themes', 'of', 'grounding', 'stability', 'and', 'manifestation', 'in', 'the', 'physical', 'realm', 'the', 'earth', 'represents', 'the', 'foundation', 'upon', 'which', 'our', 'experiences', 'take', 'root', 'it', 'underscores', 'the', 'importance', 'of', 'anchoring', 'our', 'emotional', 'and', 'spiritual', 'aspirations', 'in', 'everyday', 'actions', 'the', 'earth', 'is', 'not', 'just', 'passive', 'backdrop', 'but', 'an', 'force', 'sustaining', 'life', 'nurturing', 'growth', 'providing', 'sustenance', 'through', 'the', 'lens', 'of', 'the', 'the', 'four', 'of', 'cups', 'suggests', 'evaluation', 'of', 'our', 'relationship', 'with', 'resources', 'and', 'physical', 'well', 'being', 'it', 'prompts', 'us', 'consider', 'how', 'we', 'using', 'our', 'tools', 'talents', 'and', 'environment', 'their', 'fullest', 'potential', 'our', 'daily', 'practices', 'and', 'habits', 'aligning', 'with', 'our', 'deepest', 'values', 'we', 'cultivating', 'balanced', 'harmonious', 'relationship', 'between', 'our', 'inner', 'and', 'outer', 'worlds', 'at', 'the', 'heart', 'of', 'this', 'card', 's', 'symbolism', 'lies', 'the', 'concept', 'of', 'manifestation', 'the', 'earth', 'teaches', 'us', 'that', 'our', 'thoughts', 'dreams', 'and', 'intentions', 'turned', 'into', 'it', 'reminds', 'us', 'take', 'action', 'our', 'plans', 'into', 'motion', 'the', 'fertile', 'soil', 'of', 'our', 'minds', 'and', 'hearts', 'must', 'tilled', 'with', 'purpose', 'and', 'nourished', 'with', 'consistent', 'effort', 'ultimately', 'the', 'four', 'of', 'cups', 'inverts', 'the', 'notion', 'of', 'what', 'constitutes', 'success']",[]
20,"El Fuego brilla en su potencia, iluminando el camino hacia un deseo mayor.

El fuego simboliza la energía y la voluntad interior que impulsa las acciones y el cambio. Él es el motor del poder divino que reside en cada ser humano, la chispa que enciende la motivación y el deseo de manifestar la voluntad en el mundo físico. El tarot de Fuego invita al buscador a reflexionar sobre la fuerza interior y cómo se manifiesta en sus acciones y decisiones. Sus cartas hablan de una necesidad de reconocer y equilibrar adecuadamente la fuerza interior. Mientras que el fuego puede ser tanto destructiva como constructiva, capaz de quemar lo viejo para dar espacio a la creación de nuevas ideas, la carta de Fuego sugiere centrarse en el deseo auténtico y cómo alinearlos con un propósito mayor. Esta lectura desafía al individuo a usar su poder interior de manera consciente y deliberada, fomentando el crecimiento personal y la transformación. El Fuego es la llama que il",es,0,161,4,165,0.0,[],"['adecuadamente', 'centrarse', 'alinearlos', 'il']"
21,"El despertar de la tierra es la iluminación del espíritu en la materia, donde las verdades internas se materializan alrededor de nosotros. En este momento, la copa de la torre está conectando los reales con la realidad, representando la unificación de la espiritualidad y el materialismo. El elemento de tierra invita a reflexionar sobre nuestro modo de interactuar con el mundo físico y cómo nuestras creencias se traducirán en acciones en la realidad. Este es el lugar para evaluar la alineación entre nuestras aspiraciones más altas y las prácticas cotidianas, asegurándose de que nuestro camino refleje nuestros valores más profundos.",es,0,99,1,100,0.0,[],['asegurándose']
22,"""El paje de bastos de Agua te lluece con los fluidos profundos del subconsciente. Al verse esta carta, sabes que debes hunderte en el lago de tus sentimientos más antiguos y escondidos. Ánimo a explorar esas aguas internas, a revelar los secretos más íntimos de tu alma. El agua es la fuente de tu ser más verdadero y la clave para conectar más profundamente con el corazón de tu ser. Haz frente a tus emociones, úsalas como un espejo que reflejione la luz de tus verdaderos deseos y la sabiduría del alma. No temas a sumergirte en el río de tus sentimientos, ya que ahí encontrarás el camino hacia una comprensión más profunda de ti mismo y de la esencia de la realidad. La carta de Agua te invita a embarcarte en un viaje de auto descubrimiento, a navegar las olas de tu alma y a encontrar tu propio camino hacia la autrealidad.""",es,0,145,8,153,0.0,[],"['lluece', 'hunderte', 'íntimos', 'úsalas', 'reflejione', 'sumergirte', 'embarcarte', 'autrealidad']"
23,"El reino de la Tierra, donde la materia se materializa y los sueños se hacen realidad, te invita a reflexionar sobre la relación entre lo espiritual y lo material. 

El elemento de la Tierra, por su estabilidad y terrenalidad, simboliza el punto en que el ser se entierra en el cuerpo y el entorno físico. Aquí, la ilusión y la fantasía dan paso a la realidad tangible. 

Pregna de potencial, la Tierra alberga el crecimiento y la manifestación. Tus creencias y metas actúan como semillas que se entierran en la tierra y florecieron en el cuerpo y el mundo exterior. 

El equilibrio entre el espíritu y el cuerpo se refleja en el elemento de la Tierra. Te anima a considerar cómo tu alma esalda y tu cuerpo responde. La salud se manifiesta en la nutrición y la circulación sanguíneo.

Pero la Tierra también puede significar obstáculos y limitaciones. Mientras que es natural y necesario, no debes lazar en",es,0,156,2,158,0.0,[],"['pregna', 'esalda']"
