Fila,Prompt,Idioma original,en,es,unknown,total,contamination,words,unknown_words
0,"In the realm of the subconscious, the Emperor's stone throne stands resolute upon the tumultuous sea. His scepter, a rod of iron, pierces the waves, anchoring order amidst the fluid chaos. The Emperor, a sentinel of structure, watches over the depths, his gaze penetrating the murky waters. His presence is a reminder that even in the most unpredictable of emotions, there lies a foundation of strength and control. The flow of feelings around him is not to be feared but acknowledged as a source of profound wisdom. The Emperor, in his watery domain, invites you to navigate the currents of your inner sea, to chart the course of your emotional tides, and to embrace the sovereignty of your own heart. Let the ebb and flow of your feelings guide you to the shores of self-awareness and the realization that within the fluidity of your emotions, there is a steadfast core of being.",en,133,21,0,154,0.136,"['sea', 'a', 'fluid', 'chaos', 'a', 'a', 'a', 'control', 'to', 'be', 'as', 'a', 'invites', 'to', 'sea', 'to', 'to', 'embrace', 'to', 'a', 'core']",[]
1,"In the alchemy of the mind, the Temperance card dances with the ethereal grace of Air, blending thoughts and whispers into a harmonious symphony. It is a reminder that within the labyrinth of our consciousness, clarity is the elixir that transforms chaos into coherence, silence into song. The seeker is called to listen to the subtle cadences of the universe, to breathe in the essence of communication that transcends mere words, and to speak with the wisdom of the stars. In this space, where Air and spirit intertwine, the seeker finds the alchemy of expression, a language that resonates with the hidden melodies of the cosmos. Here, in the delicate balance of thought and communication, lies the path to enlightenment, a journey where each breath is a step towards understanding the intricate tapestry of existence.",en,117,18,0,135,0.133,"['dances', 'a', 'a', 'elixir', 'chaos', 'to', 'listen', 'to', 'to', 'mere', 'to', 'a', 'cosmos', 'here', 'balance', 'to', 'a', 'a']",[]
2,"In the realm of earthly endeavors, you stand at the edge of a horizon that stretches beyond the familiar, where the whispers of the wind carry the scent of potential. Your gaze is fixed upon a distant land, where dreams take root and ambitions bloom. The Three of Wands, a silent sentinel, marks your presence in this vast expanse, a testament to the seeds of intention you have sown. Here, in the fertile soil of the material world, your aspirations find purchase, and your spirit, a steadfast gardener, tends to the burgeoning fruits of your labor. The earth beneath your feet, rich and bountiful, cradles the weight of your aspirations, grounding you in the tangible reality of your endeavors. Embrace the nurturing embrace of the earth, for it is here, amidst the solidity of your achievements, that your deepest yearnings find form, and your inner visions are given shape.",en,130,19,0,149,0.128,"['stand', 'a', 'familiar', 'a', 'land', 'a', 'a', 'to', 'here', 'material', 'a', 'to', 'labor', 'tangible', 'reality', 'embrace', 'embrace', 'here', 'are']",[]
3,"In the quietude of your earthly abode, you find the Ten of Pentacles nestled within the folds of your dreams. Here, the tapestry of your lineage weaves a story of abundance and legacy, a testament to the seeds of labor and love sown through generations. This card is a harbinger of the fruits of your endeavors, a symbol of the material and emotional wealth that flourishes when roots are deep and foundations are strong. It is a reminder that the earth beneath your feet is not merely a vessel for your aspirations but a nurturing cradle that sustains your every endeavor. In this realm of plenty, you are both the steward and the beneficiary of the earth's bounty, a custodian of the physical and the tangible, where each coin in the well-guarded treasure is a reflection of your inner riches. Embrace the cycle of giving and receiving, for in this dance of reciprocity, you find the essence of your connection to the earth, a bond that anchors you in the here and now, grounding your spirit in the fertile soil of your existence.",en,160,25,0,185,0.135,"['quietude', 'ten', 'here', 'a', 'a', 'to', 'labor', 'a', 'a', 'material', 'are', 'are', 'a', 'a', 'a', 'are', 'a', 'custodian', 'tangible', 'a', 'embrace', 'dance', 'to', 'a', 'here']",[]
4,"In the realm of earthly endeavors, you stand amidst the fertile loam, a sovereign amidst the silent whispers of growth. The Queen of Swords, a guardian of your inner sanctum, wields her blade not to cleave but to carve a path through the dense underbrush of material entanglements. Her eyes, sharp as the crescent moon, pierce through the veils of illusion, discerning the true value of your earthly treasures. She is the embodiment of clear-sighted wisdom, the silent sentinel who ensures that your resources are not squandered but nurtured, like a precious garden, to bloom in due season. Her presence is a reminder that the stability you seek is not found in the accumulation of wealth but in the judicious use of your earthly bounty. She beckons you to tend to your physical vessel with the same reverence you would bestow upon a sacred temple, for it is through this vessel that your deepest aspirations find form and expression. In her shadow, you discover the strength to stand firm, rooted in the rich soil of your convictions, as the world around you shifts and turns. Here, in the quietude of your earthly existence, you are both the steward and the embodiment of your material world, a testament to the enduring power of transformation.",en,180,34,0,214,0.159,"['stand', 'a', 'queen', 'a', 'her', 'to', 'to', 'a', 'dense', 'material', 'her', 'eyes', 'as', 'true', 'are', 'a', 'to', 'her', 'a', 'use', 'to', 'to', 'a', 'temple', 'her', 'to', 'stand', 'as', 'here', 'quietude', 'are', 'material', 'a', 'to']",[]
5,"In the garden of your inner sanctum, the Queen of Pentacles tends to her earthly domain with a gentle, nurturing hand. Her touch is the whisper of a stream, soothing and life-giving. She sits beneath an ancient oak, its roots entwined with her own, a testament to the enduring dance of growth and sustenance. Her crown, a wreath of ivy, adorns her with the verdant embrace of nature's own healing balm. She is the keeper of the hearth, where the embers of intuition glow with the light of inner knowing. Her eyes, reflecting pools of tranquil depth, mirror the soul's journey through the fluid realms of emotion. In her presence, the waters of feeling rise and mingle with the earth, nourishing the seeds of understanding sown in the fertile soil of the heart. Here, in the confluence of water and earth, the Queen invites you to bathe in the clarity of your own emotions, to embrace the ebb and flow of your inner tides, and to anchor your feelings in the stability of your being.",en,147,31,0,178,0.174,"['queen', 'to', 'her', 'a', 'her', 'a', 'her', 'a', 'to', 'dance', 'her', 'a', 'her', 'embrace', 'nature', 'light', 'her', 'eyes', 'tranquil', 'soul', 'fluid', 'her', 'rise', 'here', 'queen', 'invites', 'to', 'to', 'embrace', 'to', 'anchor']",[]
6,"In the realm of the Ten of Cups, emotions cascade like a waterfall, each droplet a memory, a feeling, a shared moment of joy. Amidst this torrent, the fire of passion ignites, a beacon of will that dances upon the waves, illuminating the depths with its fervent glow. This is the alchemy of the soul, where the emotional abundance of the Ten of Cups meets the transformative power of Fire. Here, the seeker is both the architect and the dwelling, crafting a life that is a testament to their deepest desires, their truest self. The fire within stirs the waters, creating ripples that touch the shores of possibility, each wave a step towards a destiny shaped by the heart's unyielding will. In this dance of elements, the seeker learns to harness the divine spark, to channel the energy of creation and change, to align their inner world with the outer expression of their dreams. The Ten of Cups in the embrace of Fire is a reminder that the most profound transformations are those that are felt, that resonate with the rhythm of the heart.",en,159,26,0,185,0.141,"['ten', 'cascade', 'a', 'a', 'a', 'a', 'a', 'dances', 'soul', 'ten', 'here', 'a', 'a', 'to', 'a', 'a', 'dance', 'to', 'divine', 'to', 'to', 'ten', 'embrace', 'a', 'are', 'are']",[]
7,"In the quietude of the Earth's embrace, the Four of Cups whispers of a solitude born from a disconnection between the inner sanctum and the world of form. Here, in the fertile soil of contemplation, the seeds of introspection are sown, yet the sprouts reach not for the light above but delve deeper into the womb of reflection. The cups, once a triad of emotion and experience, now stand alone, their rim kissed by the mist of unacknowledged feelings. The figure, cloaked in the earth's rich tapestry, gazes beyond the offerings laid before them, seeking a resonance that aligns with the symphony of their soul's yearning. This moment calls for a rekindling of the earth's nurturing touch, a reawakening to the sustenance that lies in the simple, the tangible, the real. It is a reminder that within the embrace of the material, there lies a pathway to the spiritual, a bridge from the earthly to the ethereal, where each resource, each morsel of matter, each breath of the physical world is an opportunity to infuse the mundane with the divine.",en,153,31,0,184,0.168,"['quietude', 'embrace', 'a', 'solitude', 'a', 'here', 'are', 'light', 'once', 'a', 'triad', 'stand', 'figure', 'a', 'soul', 'a', 'a', 'to', 'simple', 'tangible', 'real', 'a', 'embrace', 'material', 'a', 'to', 'a', 'bridge', 'to', 'to', 'divine']",[]
8,"In the theater of your soul, the stage is set ablaze with the fervor of a thousand suns. Here, in the crucible of your own making, the alchemy of will and desire transmutes the leaden weight of the mundane into the golden essence of purpose. The Ten of Swords does not herald the end but the culmination of a journey where each blade is a testament to the trials overcome, a dance of destruction that clears the way for rebirth. Embrace the conflagration, for within its roaring heart lies the seed of a new dawn, a phoenix rising from the ashes of the old. Your will, a relentless fire, scorches the earth of your past, leaving behind a fertile ground for the seeds of your aspirations to take root. Let the flames guide you, for they are the messengers of transformation, the heralds of a future shaped by the unyielding force of your spirit.",en,134,20,0,154,0.13,"['soul', 'set', 'fervor', 'a', 'here', 'transmutes', 'ten', 'a', 'a', 'to', 'a', 'dance', 'embrace', 'a', 'a', 'a', 'a', 'to', 'are', 'a']",[]
9,"In the quietude of the earth's embrace, a chalice emerges from the soil, its cup brimming with the purest of waters. This is the genesis of nourishment, the wellspring of life's sustenance. It is the promise of abundance, a testament to the cyclical dance of giving and receiving. The Ace of Cups, in its earthly manifestation, speaks of the fertile ground from which new beginnings in emotional abundance and spiritual connection can flourish. It is a reminder that within the tangible realm, the heart's desires can take root and blossom, supported by the earth's generosity. Here, in the richness of the material plane, lies the potential for a harmonious symphony of spirit and matter, where the well-tended garden of the soul yields to the bountiful harvest of the heart.",en,115,18,1,134,0.134,"['quietude', 'embrace', 'a', 'emerges', 'a', 'to', 'dance', 'can', 'a', 'tangible', 'can', 'here', 'material', 'plane', 'a', 'tended', 'soul', 'to']",['purest']
10,"In the realm of your inner flame, the Page of Wands stands at the edge of a tranquil pool, the surface of his reflection a canvas of swirling currents. He is the dreamer who walks the tightrope between the fiery hearth of ambition and the fluid depths of the soul. His gaze is fixed upon the horizon, where the dance of light and water converge, a testament to the harmony of passion and emotion. The Page invites you to plunge into the waters of your subconscious, to navigate the streams of your feelings with the curiosity of a child and the wisdom of a sage. Let the ebb and flow of your inner tides guide you to the shores of self-awareness, where the embers of your heart speak in a language understood only by the soul. In this journey, remember that the emotions which you navigate are not storms to be weathered but rivers that lead to the ocean of understanding. Embrace the fluidity of your feelings, for in their depths lies the map to your truest self.",en,154,25,0,179,0.14,"['a', 'tranquil', 'a', 'he', 'fluid', 'soul', 'dance', 'light', 'converge', 'a', 'to', 'invites', 'to', 'to', 'a', 'a', 'to', 'a', 'soul', 'are', 'to', 'be', 'to', 'embrace', 'to']",[]
11,"In the quietude of the Earth's embrace, the Strength card whispers of a serene dominion over the tangible, a gentle assertion of will that coaxes the dormant into bloom. Here, in the fertile soil of the material realm, the lion's fierce heart tames not through dominance but through understanding, a harmonious dance of spirit and flesh. The Strength you possess is not in the grip of might but in the tender grasp of nurturance, where each resource is a seed to be cherished, each breath a chance to weave the ethereal into the fabric of the earthly. In this dance, you are both the dancer and the dance, a symphony of intention and action, where every step is a note in the grand composition of your life's journey. Embrace the earthly with a gentle hand, for in your care, the world finds its balance, and within you, the strength of the earth becomes a wellspring of boundless potential.",en,131,29,1,161,0.18,"['quietude', 'embrace', 'a', 'serene', 'tangible', 'a', 'here', 'material', 'a', 'dance', 'tender', 'a', 'to', 'be', 'a', 'chance', 'to', 'dance', 'are', 'dance', 'a', 'a', 'note', 'grand', 'embrace', 'a', 'care', 'balance', 'a']",['nurturance']
12,"En el baño de la luna, el Emperador se encuentra en la orilla del lago, su mirada refleja en el agua que murmura con los secretos de la noche. Su presencia estable, la tierra bajo sus pies firme y fecunda. Sus manos, tiendan la red de un imperio que se extiende más allá de las olas que besan sus anzuelos. El agua, cuna de los sentimientos, se mece con la brújula de su corazón, guiándolo a través de las corrientes de la emoción, donde cada corriente es un hilo que teje la trama de tu ser. En este viaje subterráneo, el Emperador es el guardián de la empatía, un faro que ilumina los abismos del subconsciente, permitiendo que las olas de la intuición te acercen y te deslices en el baño de sus reflejos. Aquí, en la confluencia del poder y la emoción, se encuentra el equilibrio entre el dominio y la fluidez, entre la estructura y la corriente, entre el ser y el sentir. Sumérgete, explorador, en las profundidades de tu propio lago, y descubre las verdades que yacen en las profundidades de tu propio imperio.",es,0,183,4,187,0.0,[],"['anzuelos', 'guiándolo', 'acercen', 'sumérgete']"
13,"En un viento que susurra los secretos del cosmos, tu mente se eleva, despejada de nubes terrenales. Cada inspiración te acerca a las alturas donde el pensamiento se funde con la luz divina. Aquí, la palabra no es meramente un sonido que se disipa en el aire, sino un puente entre lo material y lo etéreo. La Templanza te guía, invitándote a respirar con paciencia, a meditar con precisión, a hablar con sabiduría. En este equilibrio, las ideas que fluyen a través de ti se purifican, se ennoblecen, se vuelven un reflejo de la armonía del universo. Recuerda que cada pensamiento es un hilo en el tejido de la realidad, cada palabra, un cimbalta en el edificio de tu existencia. En la danza de la comunicación, te invitan a ser el coreógrafo, a dirigir con gracia y firmeza, a crear un espacio donde la verdad y la belleza se encuentran en el silencio entre las oraciones.",es,0,154,2,156,0.0,[],"['invitándote', 'cimbalta']"
14,"En el entrecruce de la tierra firme y el flujo de la vida, tu presencia se asienta con la certeza de las raíces. La tierra te abraza con sus brazos de abajo, ofreciendo un sustrato para la manifestación de tus sueños. Aquí, cada paso resuena con la estabilidad de lo que ya has construido, y cada respiración se sincroniza con el ritmo de lo que aún esperas sembrar. En este momento, la tierra te invita a sentir el peso de tu propia realidad, a reconocer las riquezas que yacen debajo de tus pies y a abrazar la tierra con las manos de un creador, no solo un receptor. La creación es un diálogo con lo tangible, un baile entre lo material y lo etéreo. En este vínculo, hallarás las claves para nutrir tus aspiraciones con la riqueza de la tierra, y en ese nutrimento, encontrarás el poder para elevar tus emociones y pensamientos hacia lo inmaterial. La tierra te aconseja: no busques solo en lo visible, sino también en lo que se oculta a tus pies, pues ahí yace el sembrado de tus futuros abrazos.",es,0,185,0,185,0.0,[],[]
15,"En el tejido de la realidad, las promesas de ayer se tejen en el hilo dorado de ahora, y cada nodo es un fruto maduro de deseos y sueños. La tierra, con sus brazos abiertos, recibe los semillas de los deseos más arraigados, y en su cálido abrazo, los nutre hasta que sus raíces se entrelazan con las venas del mundo material. Aquí, en este encuentro de lo etéreo y lo tangible, el Diez de Oros emerge como un mapa de las rutas que conectan el espíritu con la riqueza de la existencia. Observa cómo cada paso resuena con la sólide certeza de lo que se ha sembrado, y recuerda que cada grano de oro que se cosecha en la tierra de lo concreto, es un testimonio de la visión que una vez se hizo realidad en el dominio de lo intangible. En este momento, la tierra te invita a reconocer el valor de lo que has construido, a apreciar la estabilidad de lo que ha tomado raíz y a sentir la riqueza de lo que está a punto de brotar.",es,0,180,1,181,0.0,[],['sólide']
16,"En el encanto de la tierra, la Reina de Espadas se alza, una figura de autoridad y dominio. Su presencia es una promesa de estructura y orden, un faro de realidad en un mar de posibilidades. Ella no solo goberna, sino que nutre y protege, su cuerpo una extensión de la tierra fértil que da vida y sostiene. Su mano tiende hacia el suelo, ofreciendo las frutas de la diligencia y la paciencia, y su mirada fija nos recuerda que la materia es un lienzo donde nuestras emociones se despliegan en paisajes de concreto y color. En este encuentro, la tierra nos invita a sentir las raíces de nuestras aspiraciones, a sentir cómo las ideas se hunden en la realidad, y a reconocer que cada paso sobre este terreno es un canto a la creación y un homenaje a la perseverancia. La Reina nos enseña que la riqueza no es solo de oro, sino de la tierra que nos nutre y de los recursos que gestionamos con sabiduría y respeto.",es,0,169,1,170,0.0,[],['goberna']
17,"En el abrazo de la Reina de Oros, las corrientes del sentir se tejen con la gracia de lo eterno. Su presencia es un santuario donde las olas del emocionario te llevan a las profundidades de tu ser, donde cada corazón latido resuena con la sabiduría de lo oculto. Sumérgete en esta danza de aguas, permitiendo que tus sentimientos te guíen a través de los mares de tu subconsciente. Aquí, en el fondo de tus emociones, descubrirás las corrientes que forman el tejido de tu alma, y en ese conocimiento, encontrarás la clave para desentrañar los misterios que yacen en las profundidades de tu espíritu. La Reina de Oros es la guardiana de este viaje, ofreciéndote su mano para que navegues con confianza entre las islas de tu intuición y las marismas de tu empatía. En este viaje, cada gota que caiga sobre ti es un susurro de tu interior, cada río que fluya a tu lado es un camino hacia la comprensión de lo que te hace humano y divino. Honra tu flujo emocional, pues en él reside la poesía de tu existencia.",es,0,180,4,184,0.0,[],"['emocionario', 'sumérgete', 'ofreciéndote', 'marismas']"
18,"En el jardín del alma, el Fuego danza con gracia, entre las copas que susurran secretos. Cada chispa es un suspiro de vida, un deseo que se alza con fervor, buscando la luz que desvela caminos ocultos. El Diez de Copas en su esplendor, es el héroe de su propia odisea, navegando entre las aguas emocionales con la voluntad de un faro. Su energía es el viento que impulsa la vela hacia horizontes inexplorados, donde cada emoción es un maestro, cada pasión, un camino. En este viaje, el Fuego no es destructor, sino transformador, purificando lo que se ha endurecido con el tiempo, permitiendo que lo nuevo brote de las cenizas de lo antiguo. El buscador debe abrazar este Fuego, permitiendo que su voluntad sea una llama que ilumine su camino, guiándolo a través de pruebas y desafíos, hacia la realización de su propia esencia.",es,0,144,1,145,0.0,[],['guiándolo']
19,"En el entrecruce de la humedad y la tierra, un jardín se esconde, donde cada gota de lluvia encuentra su lugar en la cuna de la raíz. Aquí, el crecimiento no es solo de las plantas, sino de las almas que aprenden a nutrirse de la simplicidad de lo físico. Las copas, en su delicado equilibrio, se inclinan hacia abajo, besando con sus pétalos la tierra, ofreciendo fruto de lo que han capturado del cielo. En este momento, recuerda que la estabilidad no es solo la de las raíces, sino también la de los corazones que mantienen viva la conexión entre lo etéreo y lo tangible. La tierra te abraza, te sostiene, y te invita a cosechar lo que has sembrado con tus emociones y tus manos. En este plano material, cada paso resuena con la promesa de una realidad que honra tu esencia.",es,0,143,1,144,0.0,[],['nutrirse']
20,"En el corazón del alma, un viento ardiente sussurra, prometiendo un viaje a través de las llamas de la transformación. Cada respiración es un incendio que consume lo que no sirve, purificando el camino hacia lo que es verdaderamente esencial. En este fuego, las sombras se disuelven y la luz se afirma, revelando un camino iluminado por el deseo de lo que se quema por desejar. Aquí, la voluntad se forja en el calor de la pasión, y cada paso es una danza con las llamas de lo que se atreve a ser. El viaje es un acto de creación, donde cada elección es una chispa que puede encender un nuevo mundo. En este abrazo ardiente, el buscador se encuentra con su propia fuerza, una y al mismo tiempo, capaz de desgarrar y de construir. La carta de Fuego es un llamado a la acción, a la determinación, y a la aceptación de la energía que reside en el núcleo de nuestra ser. En este fuego, se encuentra la esencia de la voluntad, un poder que, manejado con sabiduría, puede transformar el mundo.",es,0,181,2,183,0.0,[],"['sussurra', 'desejar']"
21,"En el abrazo de la tierra, tu raíz se entrelaza con los sueños de la tierra misma. Cada paso resuena con la promesa de la creación, cada respiración te conecta con la red de vida que te nutre. En este encuentro, el as de copas emerge como un flujo constante, una fuente de inspiración que te recuerda que el amor y la emoción son las piedras angulares de la realidad que te rodea. Este arcanum te invita a abrazar la plenitud de tu existencia, a reconocer que cada emoción que fluye a través de ti es un reflejo de la tierra que te amorosamente sostiene. En este momento, la tierra te ofrece su mano, deseosa de compartir con ti los frutos de tu labor, los recursos de tu entorno y el amor de tu corazón. Recibe estos regalos con gracia y sabiduría, y deja que tu presencia en el mundo sea un testimonio de la belleza y la riqueza que fluye desde lo material hacia lo divino.",es,1,166,0,167,0.006,['arcanum'],[]
22,"En el encantador baile de las corrientes emocionales, el Paje de Bastos navega con gracia y curiosidad. Su presencia es un susurro de aguas cristalinas, reflejando los contornos de un mundo donde las profundidades se entretejen con la superficie. En este viaje, cada olas es un sentimiento, cada corriente, una intuición. El Paje, con su mirada llena de cuento, invita a sumergirse en las aguas de lo desconocido, donde cada gota es un fragmento de sabiduría oculta, cada maraña, un enigma del subconsciente. Su mano tiende hacia lo desconocido, prometiendo ser el guía a través de los ríos de lo emocional, donde cada emoción es un río que nos lleva a entender mejor el flujo de nuestra esencia. En este viaje, el Paje nos recuerda que cada sentimiento es un mensaje, cada llanto y sonrisa, una letra en el poema de nuestra existencia. Honra tu corazón, que en sus sentimientos yacientes, reside la clave para desentrañar los misterios de tu ser.",es,0,159,2,161,0.0,[],"['sumergirse', 'yacientes']"
23,"En el tejido de la realidad, la Fuerza se manifiesta como la tenaz raíz que nutre y sostiene. Es el cimarrón que emerge a través de la tierra, desafiando las adversidades, con la inquebrantable determinación de convertir visión en forma. En este entorno de Tierra, cada paso resuena con la resonancia de lo que está a punto de brotar, y cada elección se siente en el hueso, con la sólide certeza de lo que se ha sembrado. La Fuerza aquí es el hilo dorado que te guía a través de la densidad, recordándote que cada obstáculo es un preludio de la resistencia que necesitas para erigir un mundo que refleje tus deseos más sinceros. En este plano material, la Fuerza te invita a abrazar la tenacidad de la vida misma, a reconocer que tienes el poder de transformar lo etéreo en lo concreto, y a recordarte que cada gesto, cada palabra y cada pensamiento contribuye a la realidad que te rodea. En este momento de reflexión, la Fuerza te recuerda que eres el arquitecto de tu propio universo, y que cada elemento de tu creación debe ser tejido con la fuerza de tus convicciones y la calidez de tu espíritu.",es,0,197,3,200,0.0,[],"['sólide', 'recordándote', 'recordarte']"
