Fila,Prompt,Idioma original,en,es,unknown,total,contamination,words,unknown_words
0,"The Water card reveals that you are currently navigating the depths of your own emotions, the ebb and flow of your inner world. This element of your psyche is a wellspring of intuition, empathy, and self-knowledge. Water, in its ever-changing forms, mirrors the fluid nature of your feelings, reflecting both the light and shadow of your inner landscape. It invites you to dive beneath the surface, to explore the hidden currents that shape your experience of reality. The Water card suggests that your emotions are not to be feared or suppressed, but rather embraced and understood. They are the vital force that propels you forward, coloring your perceptions and guiding your choices. By immersing yourself in the flow of your feelings, you open the door to profound self-discovery. The Water card is a reminder to honor the power of your emotions, to use them as a compass for navigating the uncharted waters of your own being.",en,134,24,1,159,0.151,"['are', 'a', 'fluid', 'nature', 'light', 'invites', 'to', 'to', 'explore', 'reality', 'are', 'to', 'be', 'are', 'vital', 'open', 'to', 'a', 'to', 'honor', 'to', 'use', 'as', 'a']",['propels']
1,"The Air card whispers secrets of the mind, 
A symphony of thoughts, a dance of ideas.
It speaks of clarity, of words well-spoken,
The power of communication, the tongue's might.
In the realm of thought, the Air reigns supreme,
A vital force that breathes life into the brain.  
It is the messenger, the conduit of dreams,
The bridge that spans from inner world to outer sphere.
Through Air, the mind connects, the soul takes flight,
In its wake, illumination, insight, and clarity.
The card invites us to tend to our thoughts,
To choose our words with care, our speech with thought.
For in the end, it is our inner world that shapes
The reality we see, the life we undertake.
So let us speak with honesty, with grace,
And let our words be a source of light.",en,120,19,0,139,0.137,"['a', 'a', 'dance', 'ideas', 'a', 'vital', 'bridge', 'to', 'soul', 'invites', 'to', 'to', 'to', 'care', 'reality', 'so', 'be', 'a', 'light']",[]
2,"The Earth card represents the tangible realm where ideas take root and manifest into physical form. In this context, the Three of Wands suggests that the querent's creative spark has found fertile ground, taking root and growing into something substantial. The card's upright position indicates that this growth is positive and expansive, bringing new opportunities and abundance into the querent's life. The element of fire associated with the Wands suggests a passionate and dynamic approach to these new endeavors, fueling the querent's drive and determination. However, the card's placement in the Earth realm also reminds the querent to stay grounded and focused on the practical aspects of their pursuits. This balance between the spiritual and the physical is essential for long-term success and fulfillment. The Earth card invites the querent to reflect on how they can align their inner vision with their outer actions, ensuring that their deepest values and aspirations are reflected in their daily practices and interactions with the material world.",en,156,13,0,169,0.077,"['tangible', 'ideas', 'has', 'positive', 'a', 'to', 'to', 'balance', 'invites', 'to', 'can', 'are', 'material']",[]
3,"The Ten of Pentacles, a card of completion and fulfillment, finds its home in the realm of Earth. This elemental sphere represents the tangible manifestation of our deepest desires and the physical manifestation of our inner world. The Ten of Pentacles invites us to explore the connection between our spiritual aspirations and our daily practices, challenging us to align our values with our actions. It prompts us to consider how we interact with the material world and how we manage our resources, encouraging a balanced and sustainable approach. The Earth card serves as a reminder that our beliefs and emotions have the power to shape our reality, and that our thoughts and actions have a direct impact on our physical well-being and the environment around us.",en,110,17,0,127,0.134,"['ten', 'a', 'elemental', 'tangible', 'ten', 'invites', 'to', 'explore', 'to', 'to', 'material', 'a', 'as', 'a', 'to', 'reality', 'a']",[]
4,"The Queen of Swords stands tall, her regal presence a testament to the power of the mind. In the realm of Earth, she reigns over the tangible aspects of our existence, the physical manifestations of our thoughts and desires. The card's imagery speaks of stability, of a foundation firmly rooted in the material world. Yet beneath this solidity lies a deeper current of transformation, of ideas taking shape and form. The Queen's sword, a symbol of intellectual prowess, cuts through the veil of the unknown, revealing new possibilities. Her crown, a representation of the self, reminds us that our true power lies not in external possessions, but in the strength of our own being. In the context of the Earth card, the Queen of Swords invites us to examine our relationship with the physical world. She challenges us to consider how we interact with our bodies, how we manage our resources, and how we navigate the challenges of the material plane. This card is a call to action, urging us to align our spiritual aspirations with our daily practices, to create a harmonious balance between the realms of the mind, heart, and body. It is a reminder that our thoughts and emotions have the power to shape our reality, and that by consciously directing our focus, we can manifest our dreams into tangible form.",en,192,34,0,226,0.15,"['queen', 'her', 'a', 'to', 'tangible', 'a', 'material', 'a', 'ideas', 'queen', 'a', 'her', 'a', 'true', 'queen', 'invites', 'to', 'examine', 'to', 'bodies', 'material', 'plane', 'a', 'to', 'to', 'to', 'a', 'balance', 'body', 'a', 'to', 'reality', 'can', 'tangible']",[]
5,"The Queen of Pentacles appears, her presence a soothing balm amidst the tempest of emotions. She embodies the essence of emotional balance, reminding us that true strength lies in embracing the ebb and flow of our feelings. Like the gentle caress of a babbling brook, her influence flows through our consciousness, revealing hidden depths and forgotten truths. She invites us to dive beneath the surface, to explore the uncharted waters of our psyche, and confront the emotions that shape our reality. The Queen of Pentacles is a beacon of intuition, guiding us towards a deeper understanding of ourselves and our place in the grand tapestry of existence. She reminds us that our emotions are not mere shadows to be feared, but powerful forces that can illuminate our path towards self-discovery and connection.",en,111,22,0,133,0.165,"['queen', 'her', 'a', 'balance', 'true', 'a', 'her', 'invites', 'to', 'to', 'explore', 'reality', 'queen', 'a', 'a', 'place', 'grand', 'are', 'mere', 'to', 'be', 'can']",[]
6,"The Ten of Cups speaks of the deep wellspring of passion and desire that lies within the human spirit. This card is a call to awaken the fiery spark of willpower that resides in us all. It invites us to look beneath the surface of our thoughts and feelings to the raw, unbridled energy of our innermost drives and motivations. The Fire card asks us to confront the authentic desires that propel us forward, to recognize the vital force that flows through our veins and animates our actions. It challenges us to align these primal urges with a higher purpose, to channel the power of our will in constructive and conscious ways. The Ten of Cups suggests that true fulfillment lies not in blindly following our impulses, but in harnessing the energy of our passions to manifest our highest aspirations. It is a call to embrace our inner fire, to let it illuminate our path and guide us towards our destiny. This card promises transformation and growth, inviting us to shed the old and make space for new possibilities to emerge. It is a reminder that we each possess an inexhaustible source of power and potential, and that by tapping into it, we can rewrite the story of our lives.",en,178,30,2,210,0.143,"['ten', 'human', 'a', 'to', 'resides', 'invites', 'to', 'look', 'to', 'to', 'to', 'vital', 'to', 'primal', 'urges', 'a', 'to', 'ten', 'true', 'impulses', 'to', 'a', 'to', 'embrace', 'to', 'to', 'to', 'emerge', 'a', 'can']","['willpower', 'propel']"
7,"The Earth card represents stability, physical manifestation, and the tangible realm of our existence. In this context, it suggests a need to ground ourselves in the here and now, to connect with our physical body and the material world around us. We may be overthinking or idealizing abstract concepts, losing touch with our earthly needs and desires. The Earth reminds us to focus on the concrete, the sensory, and the practical. It invites us to examine how we interact with our body, our resources, and our environment. Are we nourishing and sustaining ourselves and others? Are we being responsible stewards of the planet? The Earth card challenges us to align our spiritual aspirations with our daily actions and habits. It prompts a deep reflection on what we value and how we live our lives in relation to the physical world.",en,120,19,1,140,0.136,"['tangible', 'a', 'to', 'here', 'to', 'body', 'material', 'be', 'to', 'concrete', 'invites', 'to', 'examine', 'body', 'are', 'are', 'to', 'a', 'to']",['overthinking']
8,"The Ten of Swords speaks of the fiery spark that resides within, the divine power that drives us to action and change. This elemental force, associated with the drive and will, is the engine of inspiration and determination. It is the creative force that ignites our passions and propels us to manifest our desires in the physical realm. The Fire card invites us to reflect on how our inner strength and motivation shape our choices and decisions. It challenges us to align our authentic drives with a higher purpose, to use our willpower consciously and deliberately. This card suggests that true transformation lies in recognizing and harnessing the power of our inner fire, channeling it towards our highest aspirations. It is a call to embrace our divine spark, to let it burn bright and guide us on the path of growth and personal evolution.",en,122,20,2,144,0.139,"['ten', 'resides', 'divine', 'to', 'elemental', 'to', 'invites', 'to', 'to', 'a', 'to', 'use', 'true', 'a', 'to', 'embrace', 'divine', 'to', 'bright', 'personal']","['propels', 'willpower']"
9,"The Earth card represents the tangible realm where our deepest longings take root and bloom. In this domain of physical manifestation, the seeds of our desires sprout into form, pushing through the soil of our experiences to reach for the light. The Earth is the stage where the ethereal becomes concrete, where the ephemeral takes on weight and substance. It is the realm of the body, where the soul's yearnings are given shape through the vessel of flesh and bone. The Earth reminds us that our thoughts and feelings are not merely abstract concepts, but powerful forces that have the capacity to transform the material world. It challenges us to consider how we cultivate and steward the resources that flow through us, and how we channel our inner fire into tangible expressions of our truth. The Earth invites us to explore the fertile ground of our being, to plant the seeds of our dreams and watch them grow into the harvest of our lives.",en,148,17,0,165,0.103,"['tangible', 'to', 'light', 'concrete', 'body', 'soul', 'are', 'bone', 'are', 'to', 'material', 'to', 'tangible', 'invites', 'to', 'explore', 'to']",[]
10,"The Page of Wands, a catalyst for change and new beginnings, emerges from the watery depths. This card invites the seeker to dive into the uncharted waters of their own emotions, to explore the hidden currents that shape their inner landscape. The Page of Wands suggests that true power lies within, waiting to be unleashed. It is a call to embrace the wild, untamed essence of one's being, to let go of inhibitions and fear. The path ahead may be uncertain, but with courage and trust in oneself, the seeker can navigate the choppy waters of the subconscious. This card is a reminder that emotions, though sometimes overwhelming, are a vital source of strength and wisdom. By immersing oneself in the flow of feelings, one can tap into the intuitive knowing that resides within. The Page of Wands encourages the seeker to honor their emotional sensitivity as a gift, a tool for connection and self-discovery. It is a invitation to embrace the full spectrum of human experience, to dance with the shadows and bask in the light of authentic expression.",en,146,36,0,182,0.198,"['a', 'emerges', 'invites', 'to', 'to', 'explore', 'true', 'to', 'be', 'a', 'to', 'embrace', 'to', 'go', 'be', 'trust', 'can', 'a', 'are', 'a', 'vital', 'can', 'resides', 'to', 'honor', 'as', 'a', 'a', 'a', 'to', 'embrace', 'full', 'human', 'to', 'dance', 'light']",[]
11,"The Strength card emerges from the Earth, a symbol of stability and physical manifestation. In this realm of resources and materiality, the Strength card represents the power to overcome challenges and maintain resilience. It speaks to the resilience of the spirit, the capacity to withstand adversity and emerge stronger. The Strength card invites us to explore the relationship between our inner strength and external circumstances. It suggests that true power lies not in external validation but in the fortitude of the soul. The Strength card encourages us to dig deep within, to access the wellspring of inner strength that resides within us. It reminds us that our greatest resource is the indomitable spirit that resides within, the ability to rise above and overcome any obstacle. The Strength card is a call to embrace our inner strength, to trust in our resilience and the power of our own being. It is a reminder that we are capable of weathering any storm, of emerging from challenges stronger and wiser.",en,142,25,0,167,0.15,"['emerges', 'a', 'to', 'to', 'to', 'emerge', 'invites', 'to', 'explore', 'true', 'fortitude', 'soul', 'to', 'to', 'resides', 'resides', 'to', 'rise', 'a', 'to', 'embrace', 'to', 'trust', 'a', 'are']",[]
12,"El Emperador, el rey de los cielos, se encuentra en el tarot de Agua. El agua, que simboliza las emociones y los sentimientos, actúa como un espejo que refleja las profundidades ocultas del psique. Esta carta invita al buscador a sumergirse en su mundo emocional, explorando y comprendiendo mejor sus propios sentimientos. El agua facilita la conexión con otros a través de la empatía, permitiendo una comprensión más profunda de las experiencias y emociones compartidas. El Emperador, como el rey de los cielos, representa la sabiduría y la iluminación. En este contexto, la carta sugiere la introspección para identificar las emociones dominantes y su impacto en la vida diaria. También anima a evaluar cómo estas emociones influyen en la toma de decisiones y en las interacciones con los demás. El Emperador es un llamado a honrar la sensibilidad emocional como una herramienta de conexión y autodescubrimiento.",es,0,141,5,146,0.0,[],"['cielos', 'sumergirse', 'cielos', 'dominantes', 'autodescubrimiento']"
13,"El Aire es un elemento fundamental en el Tarot que representa la comunicación, el pensamiento y la inteligencia. En la carta de Aire, se destaca la importancia de una comunicación clara tanto interna como externa. Esta carta simboliza la necesidad de explorar cómo nuestros pensamientos y palabras moldean la realidad personal, y cómo la claridad en esta área puede llevar a un entendimiento más profundo de nosotros mismos y del entorno que nos rodea. El Aire actúa como el vehículo a través del cual las ideas divinas se materializan en la conciencia humana, promoviendo la claridad mental y la capacidad de discernimiento. Cada respiración es vista como una oportunidad para conectarse con la sabiduría superior. Este intercambio va más allá de la toma de oxígeno, involucrando la absorción y el procesamiento de influencias espirituales. En este sentido, el Aire es fundamental para la formación y la articulación del pensamiento, esencial para la comunicación efectiva y la inteligencia.",es,0,156,1,157,0.0,[],['conectarse']
14,"El tres de bastos, una carta de tierra, invita a reflexionar sobre la relación entre el espíritu y la materia. Esta carta simboliza la manifestación física de nuestras ideas y emociones, la estabilidad y el aspecto tangible de nuestra existencia. En el contexto del tarot, la tierra está relacionada con la materialización de conceptos en formas concretas, incluyendo la relación con el cuerpo, los recursos y el entorno físico. La tierra representa el punto final en el descenso del espíritu hacia la materia, donde los conceptos se vuelven realidad tangible. Este elemento es esencial para comprender cómo nuestras creencias y emociones se traducieron en acciones y manifestaciones físicas. La tierra no solo representa solidez e inmovilidad, sino también la capacidad de sostener y nutrir la vida, proporcionando un terreno fértil para el crecimiento y la realización personal. En la tirada estrella del autoconocimiento, la carta de tierra invita a reflexionar sobre cómo interactuamos con el mundo material y cómo gestionamos nuestros recursos. Ofrece la oportunidad de considerar la alineación entre nuestras aspiraciones espirituales y nuestras prácticas diarias. Esta carta desafía al consultante a evaluar su relación con el dinero, la salud y el medio ambiente, promoviendo un enfoque equilibrado y sostenible que reflejera sus valores más profundos.",es,0,205,2,207,0.0,[],"['autoconocimiento', 'reflejera']"
15,"El diez de Oros, en el contexto de la carta de Tierra, invita a reflexionar sobre la relación entre el espíritu y la materia. Esta carta simboliza la manifestación física de nuestras ideas y emociones, la estabilidad y el aspecto tangible de nuestra existencia. El elemento Tierra es esencial para comprender cómo nuestras creencias y sentimientos se traducieron en acciones y manifestaciones concretas, incluyendo la relación con el cuerpo, los recursos y el entorno físico. La Tierra no solo representa solidez e inmovilidad, sino también la capacidad de sostener y nutrir la vida, proporcionando un terreno fértil para el crecimiento y la realización personal. En la Tirada Estrella del Autoconocimiento, la carta de Tierra invita a reflexionar sobre cómo interactuamos con el mundo material y cómo gestionamos nuestros recursos. Ofrece la oportunidad de considerar la alineación entre nuestras aspiraciones espirituales y nuestras prácticas diarias. Esta carta desafía al consultante a evaluar su relación con el dinero, la salud y el medio ambiente, promoviendo un enfoque equilibrado y sostenible que refleje sus valores más profundos.",es,0,173,1,174,0.0,[],['autoconocimiento']
16,"La Reina de Espadas se encuentra en el mundo de la Tierra, donde la realidad tangible y concreta se manifesta. Esta carta invita a reflexionar sobre la relación entre nuestra espiritualidad y la vida material. Puedes considerar cómo tus creencias y emociones se traducieron en acciones y manifestaciones físicas en tu vida diaria. ¿Cuán bien alineada está tu relación con el dinero, tu salud y el medio ambiente con tus aspiraciones más elevadas? Esta carta te invita a evaluar ese equilibrio y a considerar un enfoque más sostenible que refleje tus valores más profundos. La Tierra no es solo un elemento estabilizador, sino también una fuente de crecimiento y realización personal. Puedes reflexionar sobre cómo interactuas con los recursos materiales disponibles para ti y cómo los utilizas para satisfacer tus necesidades y lograr tus objetivos. La Reina de Espadas te recuerda que la estabilidad y la manifestación física son esenciales para el bienestar y el crecimiento humanos.",es,0,154,3,157,0.0,[],"['manifesta', 'cuán', 'interactuas']"
17,"El Reina de Oros se encuentra en el mundo de la Agua, donde las emociones y los sentimientos se mueven con la fluidez de un río. Esta carta invita al buscador a sumergirse en el mundo emocional, a explorar y comprender mejor sus propios sentimientos más íntimos. El agua simboliza el flujo de las emociones, las profundidades del subconsciente y la conexión con la intuición. El Reina de Oros actúa como un espejo, reflejando las profundidades ocultas del psique y revelando secretos internos y verdades olvidadas. Esta carta sugiere la introspección para identificar las emociones dominantes y su impacto en la vida diaria. También anima a evaluar cómo estas emociones influyen en la toma de decisiones y en las interacciones con los demás. El Reina de Oros es un llamado a honrar la sensibilidad emocional como una herramienta de conexión y autodescubrimiento.",es,0,138,4,142,0.0,[],"['sumergirse', 'íntimos', 'dominantes', 'autodescubrimiento']"
18,"El fuego es la fuerza vital que impulsa la acción y el cambio. Este elemento representa la chispa divina que enciende la motivación y el deseo de manifestar la propia voluntad en el mundo físico. El Fuego es una manifestación del poder divino que reside en cada ser humano. Este poder es el motor detrás de la creatividad, la inspiración y la determinación. La energía del Fuego es tanto destructiva como constructiva, capaz de quemar lo que es viejo y obsoleto para dar espacio a nuevas creaciones. En este sentido, representa la purificación a través de la cual las personas pueden reinventarse a sí mismas y sus vidas. La carta de Fuego alude a la necesidad de reconocer y canalizar adecuamente la fuerza interior. Invita al buscador a considerar cómo su impulso y voluntad se manifiestan en sus acciones y decisiones. Además, sugiere reflexionar sobre los deseos auténticos que motivan estas acciones y cómo alinearlos con un propósito superior. Esta carta desafía al individuo a usar su poder interior de forma consciente y deliberada, fomentando el crecimiento personal y la transformación.",es,0,178,3,181,0.0,[],"['reinventarse', 'adecuamente', 'alinearlos']"
19,"El Cuatro de Copas de la Tarot, en el contexto de la carta de Tierra, invita a reflexionar sobre la relación entre nuestra esencia espiritual y las manifestaciones tangibles de nuestra vida. Esta carta nos recuerda que, aunque los pensamientos y las emociones sean intangibles, su impacto se hace sentir en el mundo material. El elemento Tierra, con su estabilidad y capacidad de sostener la vida, nos recuerda que nuestras creencias y aspiraciones no quedan vacías, sino que se traducieron en acciones y manifestaciones concretas. Esta carta desafía al consultante a evaluar su relación con los recursos materiales y el medio ambiente, promoviendo un enfoque equilibrado y sostenible que refleje sus valores más profundos. El Cuatro de Copas nos recuerda que, aunque los aspectos espirituales sean invisibles, su influencia se hace sentir en cada una de nuestras acciones y decisiones.",es,1,139,0,140,0.007,['intangibles'],[]
20,"El fuego es la fuerza vital que impulsa la acción y el cambio. Este elemento representa la chispa divina que enciende la motivación y el deseo de manifestar la propia voluntad en el mundo físico. El Fuego es una manifestación del poder divino que reside en cada ser humano. Este poder es el motor detrás de la creatividad, la inspiración y la determinación. La energía del Fuego es tanto destructiva como constructiva, capaz de quemar lo que es viejo y obsoleto para dar espacio a nuevas creaciones. En este sentido, representa la purificación a través de la cual las personas pueden reinventarse a sí mismas y sus vidas. La carta de Fuego alude a la necesidad de reconocer y canalizar adecuamente la fuerza interior. Invita al buscador a considerar cómo su impulso y voluntad se manifiestan en sus acciones y decisiones. Además, sugiere reflexionar sobre los deseos auténticos que motivan estas acciones y cómo alinearlos con un propósito superior. Esta carta desafía al individuo a usar su poder interior de forma consciente y deliberada, fomentando el crecimiento personal y la transformación.",es,0,178,3,181,0.0,[],"['reinventarse', 'adecuamente', 'alinearlos']"
21,"El As de Copas, en el contexto de la Tierra, invita a reflexionar sobre la relación entre nuestra esencia espiritual y las manifestaciones tangibles de nuestra vida. Esta carta nos recuerda que, aunque los pensamientos y las emociones sean intangibles, su impacto se hace sentir en el mundo material. El As de Copas simboliza la habilidad de transformar la energía espiritual en formas concretas, como la creación de algo nuevo o la manifestación de un sueño. En este sentido, la carta nos urge a considerar cómo estamos utilizando nuestros recursos y recursos internos para construir una vida que refleje nuestros valores más profundos. ¿Estamos invirtiendo nuestra energía en formas que nutricieron y sostengan nuestra alma, o estamos permitiendo que nuestros pensamientos y sentimientos se desvanecan en el vacío? El As de Copas nos recuerda que, en el mundo material, la estabilidad y la solidez son esenciales para el crecimiento y la realización personal. Al mismo tiempo, nos invita a considerar cómo podemos llevar nuestra espiritualidad a la práctica diaria, transformando nuestros pensamientos y sentimientos en acciones que mejoran nuestra vida y el mundo que nos rodea. Esta carta nos desafía a encontrar un equilibrio entre nuestras aspiraciones espirituales y nuestras prácticas materiales, promoviendo un enfoque sostenible y auténtico que refleje nuestra verdadera naturaleza.",es,1,210,2,213,0.005,['intangibles'],"['nutricieron', 'desvanecan']"
22,"El Paje de Bastos, en su simbolismo poético, nos invita a sumergirnos en el flujo de nuestras emociones más profundas. Como el agua, este elemento es esencial para el desarrollo espiritual, permitiendo a las personas conectarse con sus sentimientos más íntimos y la sabiduría intuitiva que ofrecen. El Agua actúa como un espejo, reflejando las profundidades ocultas del psique y revelando secretos internos y verdades olvidadas. El tarot nos recuerda que las emociones, aunque a veces turbulentas, son una fuente vital de información sobre el verdadero ser y las necesidades de uno. Además, el Agua facilita la conexión con otros a través de la empatía, permitiendo una comprensión más profunda de las experiencias y emociones compartidas. Esta carta sugiere la introspección para identificar las emociones dominantes y su impacto en la vida diaria. También anima a evaluar cómo estas emociones influyen en la toma de decisiones y en las interacciones con los demás. El Paje de Bastos es un llamado a honrar la sensibilidad emocional como herramienta de conexión y autodescubrimiento.",es,0,166,5,171,0.0,[],"['sumergirnos', 'conectarse', 'íntimos', 'dominantes', 'autodescubrimiento']"
23,"La Fuerza, la Tierra, la manifestación física. El punto final del descenso del espíritu hacia la materia, donde los conceptos se vuelven realidad tangible. La estabilidad y la solidez de nuestra existencia, la capacidad de sostener y nutrir la vida, un terreno fértil para el crecimiento y la realización personal. La alineación entre nuestras aspiraciones espirituales y nuestras prácticas diarias, un equilibrio sostenible que refleje nuestros valores más profundos. El dinero, la salud, el medio ambiente - todos los aspectos de nuestra vida material se encuentran en la esfera de la Tierra. Esta carta nos invita a reflexionar sobre cómo interactuamos con el mundo material, cómo gestionamos nuestros recursos de manera responsable y equilibrada. Nos urge a evaluar la alineación entre nuestras creencias más preciadas y nuestras acciones concretas, a asegurarnos de que nuestra vida material refleje nuestros valores más esenciales. La Tierra es el punto de encuentro entre el espíritu y la materia, entre nuestras aspiraciones más elevadas y las formas concretas en las que se materializan. En el contexto del Tarot, esta carta nos recuerda la importancia de mantener una conexión profunda y equilibrada con el mundo material, de gestionar nuestros recursos de manera sostenible y responsable. Nos invita a considerar cómo podemos manifestar nuestras ideas y emociones de manera más tangible, cómo podemos traducir nuestros conceptos más abstractos en acciones y manifestaciones físicas que reflejen nuestros valores más profundos.",es,0,230,1,231,0.0,[],['asegurarnos']
