Fila,Prompt,Idioma original,en,es,unknown,total,contamination,words,unknown_words
0,"The tarot card draws you into a realm beyond the physical, into the realm of emotions and the depths of your own being. The Water card is a powerful symbol, inviting you to dive into the waters of your own psyche. It speaks of the transformative power of emotions, how they shape and reflect the very fabric of who you are. The churning waters of the subconscious, both the beauty and the beast, arise from the depths. Emotions are the currents that propel you, the waves that wash over you. The Water card is a mirror that reveals the truths you have yet to see, the hidden currents that guide you. It beckons you to immerse yourself in the ocean of your feelings, to explore the turbulent waters within. The depths of your emotional world are a source of both pain and pleasure, a wellspring of both darkness and light. The call of the Water card is to wade into the depths, to encounter the parts of yourself you keep hidden away. In the waters, you will find the truth of who you are. The emotional tides will rise and fall, carrying you to uncharted waters. Your feelings are the tides that carry you, the currents that propel you forward. The journey of the Water",en,192,21,2,215,0.098,"['tarot', 'a', 'a', 'to', 'are', 'are', 'a', 'to', 'to', 'to', 'explore', 'are', 'a', 'a', 'light', 'to', 'to', 'are', 'rise', 'to', 'are']","['propel', 'propel']"
1,"<tarot reading>
The Air card reveals a dynamic, ever-shifting landscape of potent influences. A whispering breeze carries the seeds of thought, each a unique notion spun from the mind's loam. In this space of pure potential, the winds of opinion and belief swirl in an unseen dance, each a kink in the fabric of consciousness. The card beckons us to step into the eye of the storm, to dive into the maelstrom of unspoken ideas, and test the weight of our convictions against their salt. It invites us to venture into the uncharted currents of our own thoughts, to confront the eddies and nodes that shape our inner world. In the tar of the Air, the mind runs like a river, carving canyons from the rock of our being. Let the current of your vision carry you, and see where it deposits the gold, the gems, the fragments of your soul. </tarot reading>",en,138,17,0,155,0.11,"['tarot', 'a', 'a', 'a', 'dance', 'a', 'to', 'to', 'ideas', 'test', 'invites', 'to', 'to', 'a', 'rock', 'soul', 'tarot']",[]
2,"The Three of Wands is the first of the Major Arcana cards, and is often associated with the physical realm, as it represents the earthly, material, and physical manifestations of our ideas. In this reading, the focus is on the tangible world and the way we interact with our environment. The cards under this card are associated with the color of yellow, which is associated with the natural world and the creative impulse. Here we find a very active, dynamic approach, where ideas are made concrete and take form through our actions. The element of the 3 of Wands is the embodiment of our dreams, desires, and will, manifesting them in the world through our efforts and actions. The trinity of the 3 of Wands, the 2 of Cups, and the 3 of Wands, together, depicts a journey from the realms of the spiritual and ethereal to the physical and sensual. The 3 of Wands challenges us to understand how our inner vision and creative impulses translate into concrete reality. It highlights the importance of taking action and making progress, as the power of our intentions and creative expression lies in the physical realm.",en,166,23,0,189,0.122,"['arcana', 'as', 'material', 'ideas', 'tangible', 'are', 'color', 'natural', 'impulse', 'here', 'a', 'active', 'ideas', 'are', 'concrete', 'a', 'to', 'sensual', 'to', 'impulses', 'concrete', 'reality', 'as']",[]
3,"The tarot card ""Ten of Pentacles"" and the theme of ""Earth"" (the material plane and resources) invite us to pause and reflect on how our inner world - our hopes, dreams and intentions - is manifesting in the tangible realm. This card speaks to the next stage of our journey, where the seeds of our spiritual practices and beliefs begin to take root and bear fruit. It asks us to examine the quality of our relationship with our environment and the physical world. How do our daily activities and the resources we manage align with our deepest aspirations? Are we harvesting the nourishment and wealth we need to carry out our path? Are we treating the earth's treasures with the reverence and care they deserve? The Earth card challenges us to cultivate a sustainable and spiritually integrated approach to life, one that bridges the realms of spirit and matter. It calls us to consider the long-term implications of our choices, the ripple effect they have on the web of life. Can we envision our individual growth and progress arising from a connection to the more, rather than just acting from individual interest? The cards are urging us to consider how our inner and outer realities are intertwined. Our spiritual practices are the seed from which the bloom of our inner and outer world",en,188,34,1,223,0.152,"['tarot', 'ten', 'material', 'plane', 'invite', 'to', 'pause', 'hopes', 'tangible', 'to', 'to', 'to', 'examine', 'do', 'are', 'to', 'are', 'care', 'deserve', 'to', 'a', 'to', 'to', 'web', 'can', 'individual', 'a', 'to', 'more', 'individual', 'are', 'to', 'are', 'are']",['harvesting']
4,"The Queen of Swords, an enigmatic and introspective figure, stands poised in her golden reganzen, her eyes upon the horizon. She surveys the landscape of the mind, her gaze steady yet piercing. The Earth, that great wheel of the world, turns beneath her feet. And what does Her Majesty see in the cards of destiny that she now holds? A call to the world that beckons. The siren's song, the call of a new adventure. A journey to the Self and its shadow, the depths of our own being. The Quest of the Soul is at hand, in an unassuming guise of a deck of 78 cards. The Moon's silent witness, always at the heels of our journey. What is it that we seek, when it comes to the Queen of Swords? What is the nature of our pilgrimage, in the realm of the known? The question of the Heart, the Heart's question. And in the end, where do we find the answer? Where does the Truth stand?",en,147,22,1,170,0.129,"['queen', 'figure', 'her', 'her', 'eyes', 'her', 'her', 'her', 'a', 'to', 'a', 'a', 'to', 'soul', 'guise', 'a', 'comes', 'to', 'queen', 'nature', 'do', 'stand']",['reganzen']
5,"The water card, a vessel of emotions,
Reflects the psyche's hidden waters.
It speaks to intuitions deep,
The depths of feelings steep.
The Queen of Pentacles, a watery throne,
Invites us to explore our own waters.
To dive beneath the surface, seek the truth, 
And discover what resides within.
The chalice offers a chance,
To taste the mysteries, experience the ripples.
For the water card, the emotional journey,
Reveals our inner waters, our hidden currents.",en,64,12,0,76,0.158,"['a', 'to', 'queen', 'a', 'invites', 'to', 'explore', 'to', 'resides', 'a', 'chance', 'to']",[]
6,"The all-consuming flames of the Fire card (Ten of Cups) ignite the vital force that drives us. The Fire card symbolizes the divine spark within, the passion that fuels our purpose. It is the undeniably creative power that burns away the old to make space for new creations. This element represents the drive to manifest our desires and bring them into the world through deliberate action. The question in this card is: How do you consciously direct your inner will to align with your highest aspirations? Reflect on the motivations that propel you. What is the fire that burns inside you? Let your ambition be a force for good as you use your will power to enact change. The Fire invites us to consider how we harness our inner strength for personal growth and transformation. It challenges us to examine the authentic desires that motivate our actions and decisions. This card asks: How do you use your drive and determination? Are you willing to burn away the old to make space for new? Do you align your will with a higher purpose? The choice is yours.",en,162,24,1,187,0.128,"['ten', 'vital', 'divine', 'to', 'to', 'do', 'to', 'be', 'a', 'as', 'use', 'to', 'invites', 'to', 'personal', 'to', 'examine', 'do', 'use', 'are', 'to', 'to', 'do', 'a']",['propel']
7,"The Four of Cups, in the context of your Self-Knowledge Star Spread, serves as a poignant reminder of how our inner world is intertwined with our physical manifestation. This card symbolizes the materialization of our beliefs, desires, and actions, inviting us to examine the tangible connection between our spirit and the concrete realm. As we navigate the shifting tides of our lives, the Four of Cups reminds us of the power we wield in shaping our reality. It challenges us to consider the impact our thoughts, emotions, and actions have upon the physical world, and to cultivate a deeper understanding of the interplay between the spiritual and the material. In this reading, the Four of Cups embodies the notion that our deepest aspirations and values are not confined to the ethereal; they have the power to transform the way we experience and interact with our environment. It encourages us to approach our relationships with the world and ourselves with a renewed sense of purpose and a commitment to more profound and sustainable practices. For in the realm of the heart, the Four of Cups reminds us that our true self is reflected in the physical tapestry of our being.",en,179,21,0,200,0.105,"['as', 'a', 'to', 'examine', 'tangible', 'concrete', 'as', 'reality', 'to', 'to', 'a', 'material', 'are', 'to', 'to', 'to', 'a', 'a', 'to', 'more', 'true']",[]
8,"I sense the indomitable power of the Fire card, the force that is the driving force of the drive and will. This potent energy resides within, urging you to harness your inner strength and determination. In the realm of the 10 of Swords, you are called to burn away the obsolete and unaligned aspects of yourself. This is a sacred space for transformation, where your willpower and desire to manifest in the physical realm is tested and purified. The trials that arise from this sacred space will challenge you to confront and integrate the shadow, the rejected parts of yourself. The Fire invites you to consciously align your inner power with your highest purpose and authenticity. It calls you to examine the true nature and source of your motivation. Are your actions and decisions springing from a place of genuine desire and will? The 10 of Swords suggests the need to purify and transform your inner world, to own the power of your drive and will. In the crucible of this card, you are called to integrate your willpower, to shine the light of your highest purpose, and to burn away the darkness and half-remembers. The fires of the 10 of Swords are the flames of the self, awaiting your conscious alignment.",en,182,26,2,210,0.124,"['i', 'resides', 'to', 'are', 'to', 'a', 'to', 'tested', 'to', 'invites', 'to', 'to', 'examine', 'true', 'nature', 'are', 'a', 'place', 'to', 'to', 'are', 'to', 'to', 'light', 'to', 'are']","['willpower', 'willpower']"
9,"The Earth card, in the throes of a Spirit reading, draws us into the tangible realm of our earthly existence. It grounds our beliefs into the concrete, inviting us to tangibly experience the manifestation of our aspirations and desires. Like the solid, immovable surface of a table, the Earth reminds us that our inner world must find its counterpart in the physical. As we stand at the nexus of our own desires and the material world, the Earth asks: How do we transform abstract yearnings into reality? It calls upon us to consider the raw ingredients of our being—health, substance, and form—concentric with our spiritual purpose. The Spirit guides us to the realization that our beliefs become tangible when they translate into action, and that our physical environment must align with our inner climate. The Earth is the mirror reflecting how our intentions materialize. In a Spirit reading, the Earth card beckons us to step beyond the ephemeral and embrace the concrete. It offers an invitation to venture into the unknown, to courageously embody our dreams, and to engage with the material world as an expression of our highest intention. The Spirit reminds us: Your desires manifest through your body and your environment.",en,180,25,0,205,0.122,"['a', 'tangible', 'concrete', 'to', 'solid', 'a', 'table', 'as', 'stand', 'material', 'do', 'reality', 'to', 'to', 'tangible', 'a', 'to', 'embrace', 'concrete', 'to', 'to', 'to', 'material', 'as', 'body']",[]
10,"The Page of Wands is a potent symbol in the Tarot. It represents the subconscious mind, hidden memories, and the depths of our psyche. The Wands are the tools we use to weave our dreams and visions into reality. This card invites us to dive into the mysterious waters of our emotional realms, where our deepest desires and fears reside. In this domain of the mind, we explore the uncharted territories of our being, confronting the parts we keep locked away. The Page of Wands prompts us to immerse ourselves in our emotional seas, swimming through the currents of our consciousness to unearth forgotten truths. It suggests we confront our shadow, embracing both the lighter and shadow aspects of our nature. The Wands implore us to be the architects of our own reality, shaping our inner world with the dreams and emotions we bring to the surface. It reminds us that our deepest waters are the source of our power, our untapped potential, and our most profound wisdom. Let the Page of Wands guide you into the unmapped waters of your own being, where the treasures of your soul are waiting to be discovered.",en,169,25,0,194,0.129,"['a', 'tarot', 'are', 'use', 'to', 'reality', 'invites', 'to', 'reside', 'explore', 'to', 'seas', 'to', 'lighter', 'nature', 'implore', 'to', 'be', 'reality', 'to', 'are', 'soul', 'are', 'to', 'be']",[]
11,"In the cards drawn, the weighty strength of this card indicates the querent's capacity for physical manifestation. The strength of the spirit is given tangible form, the power to manifest in the material realm. A grounding force, the Earth card reveals how the querent's deepest desires and aspirations take shape in the visible world. The card signifies the interplay between the ethereal and the earthly, showing how the spiritual is made real through the touch of the physical. It prompts the querent to consider the tangible implications of their beliefs and the impact of their actions in the context of the material plane. The element of stability and immobility, represented by the Earth, highlights the need for a balance between the desire for growth and the need to stay grounded. The card offers a reminder to savor the journey of transformation, allowing the querent to discern and integrate the wisdom gained from the interplay of the celestial and the earthly. The strength and stability of the Earth reveals the power of the querent's inner strength and resilience, even in the face of external forces seeking to undermine their power. In the Self-Knowledge Star Spread, this card invites a clear vision of how the querent's spirit and substance are translated through the medium of physical",en,198,21,0,219,0.096,"['tangible', 'to', 'material', 'a', 'visible', 'real', 'to', 'tangible', 'material', 'plane', 'a', 'balance', 'to', 'a', 'to', 'to', 'celestial', 'to', 'invites', 'a', 'are']",[]
12,"El Emperador es la carta más tierna de tu tarot. Éste es un momento de diversión y aventura, una oportunidad para dejar que partes del yo más profundo florecan y conectar de manera más auténtica. El Emperador es el guia del self, la parte más accesible de tu anágora y que permite tu acceso a nuevos aspectos de ti mismo. El guia de la intuición emocional, El Emperador te invita a explorar las profundidades de tu psique, a permitir que la empatía sea tu guía. Algunos de tus emociones más significivas y dominantes pueden estar escondidas en la esencia más profunda de tu ser. El Emperador anima a sumergir en el mar de tus sentimientos y experimentar el poder de tus emociones. Busca ser más auténtico a tu mismo en los siguientes días. Aunque a veces las emociones sean desordenadas, El Emperador te guia a un descansar más profundo y una comprensión más abrigo de los ciclos de tu vida. El Emper",es,1,156,5,162,0.006,['self'],"['florecan', 'anágora', 'significivas', 'dominantes', 'emper']"
13,"El Aire es el elemento tarot que conecta la comunicación, la inteligencia y las fueras mentales. El Aire es la representación del aliento vital que une a los humanos con las fuerzas universales, facilitando la transmisión de ideas y la interacción social. En la simbología tarot, el Aire simboliza el aliento vital que amanha la mente, lo esencia para la formación y la articulación del pensamiento. Cada respiración es vista como una oportunidad para conectar con la sabiduría superior. El Aire actúa como el vehículo a través del cual las ideas divinas se materializán en la conciencia humana, promoviendo la claridad mental y la capacidad de discernir. El Aire es asociado con el principe vital que animación la mente, lo esencia para la formación y la comunicación. El tarot de Aire sugiere una exploración de cómo los pensamientos y las palabras moldean la realidad personal, y cómo la claridad en esta área puede llevar a un entendimiento más profundo de uno mismo y del entorno.",es,0,163,2,165,0.0,[],"['amanha', 'principe']"
14,"La carta de Tierra, una representación ruda de la realidad material, puede despertar nuestros ojos a los desosaros de la visión y la percepción. Al igual que la Leda, la carta del plan, puso en claridad nuestros mundanos, la forma en que entran los elementos del espíritu en la materia, la materialización de nuestras creencias en formas tangibles. El plan representa el escala y el punto final, el descenso del espíritu hacia la materia, donde los conceptos se vuelven realidad tangible. 

En este contexto, la cartea de Tierra, alineada con el hieno, pone en evidencia. Ponderamos qué tan desalumbró la luz por los árboles, el sonido por el aire, el olor por el humo—illas invisibles de vida que no alcanzan la mente, pero que de todos modos nos influye, desde las cálidas conversaciones a los largos viajes. El hieno, en sus múdulos, nos permite reconocer estos elementos en nosotros y en el mundo, los recursos y el entorno que infl",es,0,155,6,161,0.0,[],"['hieno', 'desalumbró', 'illas', 'hieno', 'múdulos', 'infl']"
15,"Aún más valiente que la luna, los diez cartas de Oros me alientan a la Tierra, el punto más material y tangible de el séptimo del palma. Cada uno de sus hijos, en sus alturas, se desvina, buscando la estabilidad física. El cuatro de Oros es la Cima, la Bóx, la Estrella de Autoconocimiento. El elemento Tierra, por su naturaleza abrazante y receptiva, puede manifestar la transformación, el acantamiento, el aliento, y el aliento de la Cima, el tráblado de un sueño. El cuñado del Oros evoca la Cima, su significado esfandido, su valor verdadero. El Oros se desvina, el Oros es la Bóx, el Oros es el Círcel, el Oros es el Círcel. El Oros es el Lado. El Oros es la Cima, el Oros es el Lado. El Oros es el Lado. El Oros es el Lado. El Oros es",es,0,133,9,142,0.0,[],"['desvina', 'autoconocimiento', 'abrazante', 'acantamiento', 'tráblado', 'esfandido', 'desvina', 'círcel', 'círcel']"
16,"Reina de Espadas, 
Ostecas emblu.

Alzando la mirada, busco los trizos del destino. El reina de espadas gesticulando su compasión, su rostro impasible y noble. Su mano extendida, acariciando la corteza de la yedas, su palma firme y estable. Cada pétal es un refugrón, cada porra una luz reflectora. El acantilado le da tonos de fortaleza, un sencilla que no teme, mientras la dura es sencilla que no cede. 

Pero como la reina de espadas, tu reina de espadas ha estado auspiante en su trono de terciios, su visión a la tierra. De su escadra a la espalda, del rebojo a la gaveta, de las farranditas bajo, cada estabordo en la gaveta. Su escardopropio, como su espalda, refleja la nobleza real. En el campo de la tierra, la reina de",es,0,119,11,130,0.0,[],"['ostecas', 'emblu', 'yedas', 'pétal', 'refugrón', 'auspiante', 'terciios', 'escadra', 'farranditas', 'estabordo', 'escardopropio']"
17,"Reina de Oros: Reina de Oros, la imagen de una estabó, seda y unida, por sobre un chas de 10 sobre un troncalado, por bajo un troncado, por alto el troncado, por el troncado, por un troncado, por un troncado, por un troncado, por un troncado, por un troncado, por un troncado, por un troncado, por un troncado, por un troncado, por un troncado, por un troncado, por un troncado, por un troncado, por un troncado, por un troncado, por un troncado, por un troncado, por un troncado, por un troncado, por un troncado, por un troncado, por un troncado, por un troncado, por un troncado, por un troncado, por un troncado, por un tron",es,1,112,1,114,0.009,['tron'],['estabó']
18,"El Fuego es uno de los elementos más conocidos en el Tarot. Representa la energía, la pasión y la fuerza de la voluntad. Al tarot, la Fuego simboliza la chispa divina que enciende el impulso y el deseo de manifestar la voluntad en el mundo físico. El Fuego es una manifestación del poder divino que reside en cada ser humano. Este poder es el motor detrás de la creatividad, la inspiración y la determinación. El Fuego es tanto destructivo como constructivo, capaz de quemar viejo obsoleto y giving espacio a nuevas creaciones. En este sentido, representa la purificación a través de la que las personas se reenventan a sí mismas y sus vidas. La carta de Fuego alude a la necesidad de reconocer y canalizar adecuadamente el poder interior. Invita al buscador a considerar cómo su impulso y voluntad se manifiestan en sus acciones y decisiones. Además, sugiere reflexionar sobre los deseos auténticos que motivan estas acciones y cómo alinearlos con un prop",es,2,158,3,163,0.012,"['giving', 'prop']","['reenventan', 'adecuadamente', 'alinearlos']"
19,"La carta del Cuatro de Copas (Oscuro) meurgezara en un momento en que el espíritu se manifestara en formas concretas, en un tarot de la Cuarta de Copas, la carta de la Tierra (Oscuro), la Avenida de las Conspiraciones entre el Sol (Cádras) y la Luna traidora, la Cádras de la Loba (Huesos), el Oraculo de la Cuerda de los Profeta, el Lugar de la Cuerda de los Profeta, la Lisis de la Cuerda de los Profeta, la Cuerda de los Profeta, el Tano de la Cuerda de los Profeta, el Lugar de la Cuerda de los Profeta, la Cuerda de los Profeta, el Lugar de la Cuerda de los Profeta, el Lugar de la Cuerda de los Profeta, la Cuerda de los Profeta, el Tano de la Cuerda de los Profeta, la Cuerda de los Profeta, la Cuerda de los Profeta, el Tano",es,0,140,4,144,0.0,[],"['meurgezara', 'cádras', 'cádras', 'oraculo']"
20,"La lectura de la carta de Fuego, en su momento de destello, revela los mútreos potenciales de la voluntad y la energía en el interior de cada individu. El poder de Fuego es simultáneamente destructor y constructor, capaz de quasar el viejo y obsoleto para dar lugar a nuevas creaciones. A través de la chispa divina, el Fuego simboliza la pasión y la fuerza vital que impulsa la acción y el cambio. El tarot de Fuego urge al buscador a considerar cómo su impulso y la voluntad se manifestan y se manifiestan en sus acciones y decisiones. Alinear el deseo auténtico con un propósito superior. Esta carta desafia reflexionar sobre los deseos más allá de la vida. El Fuego alude a la necesidad de reconocer y fomentar la canalización adecuada de la fuerza interior. Invita considerar cómo la consciencia de la energía de Fuego puede transformar la vida. Ahora responde solo con la lectura.",es,0,151,3,154,0.0,[],"['mútreos', 'individu', 'desafia']"
21,"El tarot de Copas es un estreche de oposición, significando: el conflicto, el mirostismo entre el campo de manas y los contactos del tarot. A sucese, el elemento de la Carta de la Estrella del Autoconocimiento, la carta de Tierra, la manifestación física, la estabilidad y el aspecto tangible de nuestro mundo. El elemento de la Oposición del tarou, el Conflicencia, se encuentra en las cartas del Oposo, significando: el mirostismo, el conflicto y el campo de la Carta de la Estrella del Autoconocimiento. Esto, mediante la Carta de la Oposo, la estrella de la Carta de la Tierra, la oposí, la relación entre: los contactos del tarou, el elemento del tarou, el mirostismo. El oposo: el conflicto entre los taros del Oposo, el Conflicencia, y la oposí, el mirostismo entre: los contactos del tarou, el elemento del tarou, el miro",es,0,121,20,141,0.0,[],"['mirostismo', 'sucese', 'autoconocimiento', 'tarou', 'conflicencia', 'oposo', 'mirostismo', 'autoconocimiento', 'oposo', 'oposí', 'tarou', 'tarou', 'mirostismo', 'oposo', 'oposo', 'conflicencia', 'oposí', 'mirostismo', 'tarou', 'tarou']"
22,"El Paje de Bastos se encuentra en el Paje de Suelos, a continuar de la carta de Bajo. Algunos de los aspectos más destacados de este paje son Los Diezas, El Lobo, El Cucup, El Pez, Los Puros, El Príncipe, El Espalda y El Torre. El Suelo es el Paje del Saber, el Paje de los Sentimientos, y el Paje de los Poderes, o el Paje de los Papires. El Suelo se relaciona con el aspecto de la empatía y la compasión, y con la intuición y los sentimientos más íntimos. El Suelos es esencial para el desenvoltamiento y la profundaación de la psique, ya que los sentimientos y el conocimiento emocional son clave para la transformación. El Suelo es el espejo de los sentimientos más íntimos, reflejando los profundos mares del subconsciente y los mordisqueos, y revelando información sobre la verdadera naturaleza de los ser, las necesidades",es,0,142,6,148,0.0,[],"['cucup', 'papires', 'íntimos', 'desenvoltamiento', 'profundaación', 'íntimos']"
23,"La Fuerza es la carta de Tierra de la Tarot. El elemento Tierra simboliza el materialización física, la estabilidad y el aspecto tangible de nuestra existencia. En el contexto de la cartomción, la Tierra está relacionada con la materialización de ideas y emociones en formas concretas, incluyendo la relación con el cuerpo, los recursos y el entorno físico. La Tierra representa el punto final en el descenso del espíritu hacia la materia, donde los conceptos se vuelven realidad tangible. Este elemento es esencial para comprender cómo nuestras creencias y emociones se traducieron en acciones y manifestaciones físicas. La Tierra no solo representa solidez e inmovilidad, sino también la capacidad de sostener y nutrir la vida, proporcionando un terreno fértil para el crecimiento y la realización personal. En la Tirada Estrella del Autoconocimiento, la carta de Tierra invita a reflexionar sobre cómo interactuamos con el mundo material y cómo gestionamos nuestros recursos. Ofrece la oportunidad de considerar la alineación entre nuestras aspiraciones espiritu",es,0,159,3,162,0.0,[],"['cartomción', 'autoconocimiento', 'espiritu']"
